year,team_id,team_name,wins,losses,ties,total_games
2015,733,Utica,18,16,0,34
2015,588,Rutgers-Camden,21,13,1,35
2015,479,NYU,12,24,0,36
2015,81,Bryant,17,32,0,49
2015,30111,Covenant,11,21,0,32
2015,337,Knox,2,29,0,31
2015,1346,St. Mary's (TX),46,10,2,58
2015,1094,George Fox,31,13,0,44
2015,514,Oakland,27,22,1,50
2015,26172,A&M-Corpus Chris,20,28,1,49
2015,589,Rutgers-Newark,18,20,0,38
2015,706,UTSA,36,18,0,54
2015,1278,Oakland City,10,15,0,25
2015,169,Creighton,22,21,0,43
2015,515,Oberlin,6,28,2,36
2015,2,Abilene Christian,14,33,0,47
2015,83,Bucknell,35,20,0,55
2015,339,Kutztown,31,18,0,49
2015,248,George Mason,23,29,0,52
2015,11276,S.C. Aiken,22,17,0,39
2015,516,Occidental,8,30,0,38
2015,333,Ky. Wesleyan,25,15,0,40
2015,30181,UVa-Wise,10,24,0,34
2015,1163,La Roche,22,15,0,37
2015,84,Buena Vista,18,20,1,39
2015,30123,Academy of Art,28,26,0,54
2015,30035,Crown (MN),13,27,0,40
2015,340,La Salle,15,22,0,37
2015,249,George Washington,25,23,0,48
2015,102,Sacramento St.,28,26,0,54
2015,86,Buffalo,13,37,0,50
2015,745,Va. Wesleyan,30,8,0,38
2015,929,Adams St.,25,23,0,48
2015,85,Buffalo St.,18,17,0,35
2015,614,St. Norbert,13,21,0,34
2015,1222,Midwestern St.,24,24,0,48
2015,251,Georgetown,15,32,0,47
2015,341,La Verne,23,19,0,42
2015,87,Butler,24,27,0,51
2015,422,Miles,7,26,0,33
2015,615,St. Olaf,15,25,0,40
2015,101,CSUN,41,15,1,57
2015,734,Valdosta St.,48,9,0,57
2015,77,BYU,39,12,1,52
2015,423,Millersville,21,25,0,46
2015,2685,BYU-Hawaii,14,32,0,46
2015,590,Sacred Heart,14,30,0,44
2015,671,La.-Lafayette,39,9,1,49
2015,88,Cabrini,27,12,0,39
2015,1305,Cairn,7,29,0,36
2015,3,Adelphi,28,20,2,50
2015,11036,Sage Colleges,18,17,0,35
2015,498,La.-Monroe,30,22,0,52
2015,519,Ohio,15,32,0,47
2015,4,Adrian,20,16,0,36
2015,257,Georgia,40,14,1,55
2015,342,Lafayette,4,37,0,41
2015,11324,Agnes Scott,12,26,0,38
2015,1096,Georgia College,47,9,2,58
2015,105,Cal Lutheran,20,21,0,41
2015,424,Millikin,16,22,0,38
2015,30119,Ohio Dominican,12,36,0,48
2015,170,Curry,13,18,0,31
2015,1162,LaGrange,25,16,0,41
2015,254,Georgia St.,38,22,0,60
2015,30166,Valley Forge,5,25,0,30
2015,1059,D'Youville,25,9,0,34
2015,591,Saginaw Valley,33,19,0,52
2015,517,Ohio Northern,24,14,0,38
2015,426,Millsaps,18,13,0,31
2015,255,Georgia Tech,16,34,0,50
2015,735,Valparaiso,16,35,0,51
2015,9004,Georgian Court,14,30,0,44
2015,258,Gettysburg,30,14,0,44
2015,5,Akron,25,26,0,51
2015,594,Saint Augustine's,21,15,0,36
2015,2746,Lake Erie,13,23,0,36
2015,1098,Glenville St.,11,33,0,44
2015,90,Cal Poly,22,33,0,55
2015,595,Saint Benedict,22,18,0,40
2015,344,Lake Forest,35,9,2,46
2015,10,Ala.-Huntsville,40,16,0,56
2015,518,Ohio St.,30,22,0,52
2015,618,St. Scholastica,31,16,0,47
2015,1044,Dallas,20,16,0,36
2015,8,Alabama,42,12,1,55
2015,15207,Ohio Valley,9,38,0,47
2015,345,Lake Superior St.,12,28,0,40
2015,600,Saint Francis (PA),31,19,0,50
2015,6,Alabama A&M,18,25,0,43
2015,8366,Goldey-Beacom,6,29,1,36
2015,92,Cal St. Dom. Hills,23,29,0,52
2015,1164,Lakeland,19,21,0,40
2015,520,Ohio Wesleyan,15,21,0,36
2015,427,Minn. Duluth,33,22,0,55
2015,606,Saint Joseph's,23,18,0,41
2015,7,Alabama St.,21,33,0,54
2015,383,Minn. St. Mankato,38,23,0,61
2015,1099,Gordon,7,23,0,30
2015,346,Lamar,26,28,0,54
2015,608,Saint Leo,39,12,0,51
2015,1240,Minn. St. Moorhead,16,27,0,43
2015,30179,Okla. Christian,30,19,1,50
2015,609,Saint Louis,36,18,0,54
2015,27854,Minn.-Crookston,4,44,0,48
2015,24342,Okla. Panhandle,16,34,0,50
2015,1343,Saint Martin's,41,20,0,61
2015,1226,Minn.-Morris,19,19,0,38
2015,30085,Lancaster Bible,16,18,0,34
2015,612,Saint Mary's (MN),18,20,0,38
2015,98,Cal St. East Bay,28,23,0,51
2015,2691,Daniel Webster,7,21,0,28
2015,522,Oklahoma,45,7,1,53
2015,620,St. Thomas (MN),35,12,0,47
2015,613,Saint Michael's,2,29,0,31
2015,739,Villanova,24,30,0,54
2015,1167,Lander,12,28,0,40
2015,617,Saint Peter's,2,40,0,42
2015,1347,Saint Rose,14,21,0,35
2015,746,Virginia,16,40,0,56
2015,521,Oklahoma St.,21,31,0,52
2015,428,Minnesota,46,9,1,56
2015,30064,Saint Vincent,24,11,0,35
2015,30041,Salem,21,16,2,39
2015,1348,St. Thomas Aquinas,11,30,0,41
2015,172,Dartmouth,25,16,1,42
2015,19117,Salem Int'l,12,33,0,45
2015,524,Old Westbury,8,24,0,32
2015,743,Virginia St.,14,17,0,31
2015,621,Salem St.,22,17,0,39
2015,97,Cal St. Fullerton,34,22,0,56
2015,674,Stanford,17,37,0,54
2015,261,Grambling,9,29,0,38
2015,347,Lane,17,15,0,32
2015,433,Ole Miss,30,25,0,55
2015,30125,Minot St.,32,21,0,53
2015,1104,Grand Canyon,28,22,0,50
2015,14,Albany (NY),30,18,0,48
2015,675,Staten Island,31,12,0,43
2015,622,Salisbury,33,6,2,41
2015,742,Virginia Tech,34,21,1,56
2015,262,Grand Valley St.,32,17,0,49
2015,16142,Misericordia,28,17,0,45
2015,525,Olivet,18,16,0,34
2015,174,Davis & Elkins,20,23,0,43
2015,623,Salve Regina,20,20,0,40
2015,8486,Lasell,9,25,0,34
2015,676,Stephen F. Austin,19,32,0,51
2015,744,Virginia Union,16,11,0,27
2015,13,Albany St. (GA),16,28,0,44
2015,624,Sam Houston St.,19,28,0,47
2015,794,Green Bay,18,28,0,46
2015,348,Lawrence,28,12,0,40
2015,625,Samford,33,22,0,55
2015,2798,Albertus Magnus,27,15,0,42
2015,175,Dayton,39,14,0,53
2015,349,Le Moyne,18,16,0,34
2015,627,San Diego,29,23,0,52
2015,15,Albion,4,28,0,32
2015,748,Wagner,9,25,0,34
2015,30055,Cal St. Monterey Bay,47,12,0,59
2015,1050,Defiance,9,25,0,34
2015,16,Albright,19,16,0,35
2015,464,Omaha,22,28,0,50
2015,626,San Diego St.,36,18,1,55
2015,17,Alcorn,2,31,0,33
2015,30141,Walsh,22,16,0,38
2015,351,Lebanon Valley,18,24,0,42
2015,180,Delaware,30,23,0,53
2015,628,San Fran. St.,12,40,0,52
2015,934,Alderson Broaddus,21,16,0,37
2015,750,Wartburg,22,17,0,39
2015,678,Stetson,31,20,0,51
2015,93,Cal St. San B'dino,28,24,0,52
2015,178,Delaware St.,21,23,0,44
2015,30013,Lee,33,17,0,50
2015,751,Wash. & Jeff.,18,18,0,36
2015,179,Delaware Valley,3,25,0,28
2015,529,Oregon,46,6,1,53
2015,630,San Jose St.,37,19,0,56
2015,263,Greensboro,22,22,0,44
2015,679,Stevens,27,11,1,39
2015,13302,Lees-McRae,6,40,0,46
2015,429,Mississippi Col.,29,21,1,51
2015,181,Delta St.,27,24,0,51
2015,631,Santa Clara,15,35,0,50
2015,1111,Greenville,24,17,0,41
2015,264,Grinnell,6,29,0,35
2015,103,Cal St. Stanislaus,15,35,0,50
2015,30163,Sarah Lawrence,6,26,0,32
2015,182,Denison,22,19,0,41
2015,18,Alfred,38,4,2,44
2015,265,Grove City,16,13,0,29
2015,21852,Stevenson,19,22,0,41
2015,2814,Washburn,27,24,0,51
2015,528,Oregon St.,26,26,0,52
2015,39,GRU Augusta,32,14,0,46
2015,680,Stillman,23,16,0,39
2015,995,Caldwell,37,14,1,52
2015,30170,Alfred St.,10,24,2,36
2015,430,Mississippi St.,35,19,1,55
2015,1112,Guilford,24,17,0,41
2015,756,Washington,40,15,1,56
2015,19,Allegheny,14,15,1,30
2015,681,Stockton,17,18,0,35
2015,266,Gust. Adolphus,34,16,0,50
2015,530,Oswego St.,5,21,0,26
2015,12399,Gwynedd Mercy,18,17,0,35
2015,352,Lehigh,39,7,1,47
2015,107,California,38,16,1,55
2015,267,Hamilton,15,17,0,32
2015,432,Mississippi Val.,15,34,0,49
2015,268,Hamline,27,13,0,40
2015,176,DePaul,22,24,0,46
2015,682,Stonehill,21,15,0,36
2015,434,Missouri,39,14,1,54
2015,279,Lehman,9,15,0,24
2015,632,Savannah St.,22,17,0,39
2015,683,Stony Brook,30,17,0,47
2015,435,Missouri S&T,11,28,0,39
2015,106,California (PA),39,11,2,52
2015,350,LeMoyne-Owen,0,18,0,18
2015,669,Missouri St.,30,25,0,55
2015,177,DePauw,33,13,2,48
2015,753,Washington Col.,16,18,0,34
2015,30135,California Baptist,42,11,0,53
2015,684,Suffolk,25,16,0,41
2015,21,Alma,28,15,2,45
2015,1170,Lenoir-Rhyne,32,19,0,51
2015,938,Alvernia,19,19,1,39
2015,270,Hampton,22,26,0,48
2015,531,Otterbein,14,20,0,34
2015,1390,Sul Ross St.,3,32,0,35
2015,28746,Alverno,20,20,0,40
2015,1115,Hanover,19,15,0,34
2015,958,Summit,5,27,0,32
2015,1289,Ouachita Baptist,11,35,0,46
2015,24317,Lesley,13,19,0,32
2015,20,DeSales,19,15,0,34
2015,271,Hardin-Simmons,22,16,0,38
2015,398,MIT,29,10,0,39
2015,1355,Schreiner,10,31,0,41
2015,755,Washington-St. Louis,33,13,0,46
2015,23008,Ozarks (AR),13,26,0,39
2015,8490,LeTourneau,19,22,0,41
2015,22,American Int'l,8,25,0,33
2015,30165,SUNY Canton,11,22,0,33
2015,24,Amherst,16,12,0,28
2015,184,Detroit,10,40,0,50
2015,30042,Mitchell,17,15,0,32
2015,939,Anderson (IN),31,11,0,42
2015,354,Lewis,28,22,0,50
2015,114,Calvin,10,22,0,32
2015,757,Wayne St. (MI),42,20,1,63
2015,1116,Harding,23,32,0,55
2015,13028,Anderson (SC),40,15,0,55
2015,185,Dickinson,15,20,0,35
2015,22235,Lewis & Clark,9,30,0,39
2015,1433,Wayne St. (NE),34,21,0,55
2015,168,SUNY Cortland,36,13,0,49
2015,1434,Waynesburg,12,26,0,38
2015,25,Angelo St.,33,17,1,51
2015,633,Scranton,19,15,0,34
2015,272,Hartford,3,43,0,46
2015,758,Weber St.,38,17,0,55
2015,26,Anna Maria,5,24,0,29
2015,1356,Seattle,16,36,0,52
2015,9012,Mo. Southern St.,15,37,0,52
2015,996,Cameron,41,18,0,59
2015,247,SUNY Geneseo,28,12,0,40
2015,27,Appalachian St.,14,35,0,49
2015,759,Webster,10,23,0,33
2015,115,Campbell,28,27,0,55
2015,760,Wellesley,23,16,0,39
2015,116,Canisius,26,19,0,45
2015,9013,Mo. Western St.,36,21,0,57
2015,475,SUNY New Paltz,19,16,0,35
2015,275,Harvard,23,21,0,44
2015,436,Mo.-St. Louis,47,6,2,55
2015,533,Pace,25,17,0,42
2015,762,Wentworth,4,22,0,26
2015,276,Haverford,25,10,1,36
2015,437,Molloy,24,27,0,51
2015,534,Pacific,19,36,0,55
2015,526,SUNY Oneonta,25,14,0,39
2015,2751,Pacific (OR),29,15,0,44
2015,439,Monmouth,19,25,0,44
2015,1297,Pacific Lutheran,23,17,0,40
2015,277,Hawaii,32,22,0,54
2015,535,Paine,6,21,0,27
2015,438,Monmouth (IL),12,22,0,34
2015,966,Arcadia,16,22,0,38
2015,30095,Dixie St.,47,7,2,56
2015,9500,SUNY Poly,13,21,0,34
2015,763,Wesley,23,12,0,35
2015,30045,Palm Beach Atl.,33,22,0,55
2015,355,Liberty,29,30,0,59
2015,2697,Hawaii Hilo,31,16,1,48
2015,205,Mont. St. Billings,31,23,0,54
2015,764,Wesleyan (CT),14,17,1,32
2015,552,SUNY Potsdam,5,26,0,31
2015,2696,Hawaii Pacific,26,21,1,48
2015,1174,Limestone,30,15,0,45
2015,30118,Dominican (CA),14,32,0,46
2015,635,Seton Hall,25,28,0,53
2015,14718,Wesleyan (GA),15,23,0,38
2015,685,Susquehanna,31,7,0,38
2015,441,Montana,16,34,0,50
2015,356,Lincoln (MO),3,49,0,52
2015,278,Heidelberg,33,8,2,43
2015,29,Arizona,38,17,1,56
2015,686,Swarthmore,5,17,0,22
2015,357,Lincoln (PA),0,26,0,26
2015,358,West Ala.,19,26,0,45
2015,117,Capital,28,14,0,42
2015,687,Sweet Briar,5,23,0,28
2015,1332,Dominican (IL),27,14,0,41
2015,30063,Seton Hill,33,15,1,49
2015,765,West Chester,40,16,0,56
2015,28,Arizona St.,34,20,1,55
2015,688,Syracuse,20,26,0,46
2015,1176,Lincoln Memorial,24,24,0,48
2015,442,Montclair St.,13,22,0,35
2015,11740,West Florida,19,30,0,49
2015,8956,Dominican (NY),34,19,0,53
2015,652,Sewanee,0,30,0,30
2015,1238,Montevallo,21,31,0,52
2015,766,West Ga.,15,31,0,46
2015,636,Shaw,7,27,0,34
2015,30136,Lindenwood (MO),17,34,0,51
2015,443,Moravian,37,6,2,45
2015,444,Morehead St.,22,24,0,46
2015,2692,Dowling,17,28,1,46
2015,689,Tampa,28,13,0,41
2015,118,Carleton,11,27,0,38
2015,1438,West Liberty,19,30,0,49
2015,637,Shenandoah,10,22,0,32
2015,1123,Henderson St.,43,15,0,58
2015,1179,Linfield,35,13,2,50
2015,8411,Ark.-Monticello,24,25,0,49
2015,189,Drake,32,21,0,53
2015,767,West Tex. A&M,45,11,0,56
2015,1124,Hendrix,14,26,0,40
2015,10870,Shepherd,20,23,0,43
2015,540,Penn,22,20,0,42
2015,190,Drew,11,27,0,38
2015,30190,Penn College,12,24,0,36
2015,120,Carroll (WI),22,17,0,39
2015,28600,Lipscomb,31,25,0,56
2015,8398,Hilbert,4,26,0,30
2015,280,Hillsdale,25,23,0,48
2015,1000,Carson-Newman,36,15,0,51
2015,361,LIU Brooklyn,23,30,0,53
2015,539,Penn St.,29,28,0,57
2015,2678,Ark.-Pine Bluff,6,34,0,40
2015,281,Hiram,9,23,0,32
2015,121,Carthage,12,22,0,34
2015,191,Drexel,19,23,0,42
2015,638,Shippensburg,17,18,0,35
2015,362,LIU Post,32,17,1,50
2015,446,Morgan St.,8,30,0,38
2015,9630,West Va. Wesleyan,38,8,2,48
2015,30081,Penn St. Harrisburg,18,19,0,37
2015,31,Arkansas,16,37,0,53
2015,1057,Drury,25,27,0,52
2015,30114,Penn St.-Abington,22,15,1,38
2015,192,Dubuque,15,27,0,42
2015,359,Livingstone,7,19,0,26
2015,1395,Tarleton St.,33,20,2,55
2015,25719,Penn St.-Altoona,29,13,0,42
2015,122,Case,32,11,0,43
2015,30151,Shorter,39,15,2,56
2015,360,Lock Haven,15,27,0,42
2015,947,Arkansas Tech,41,22,0,63
2015,99,Long Beach St.,28,24,0,52
2015,538,Penn St.-Behrend,25,16,0,41
2015,123,Castleton,17,12,0,29
2015,283,Hofstra,37,12,2,51
2015,1439,West Virginia St.,27,18,0,45
2015,33,Armstrong,32,16,0,48
2015,30044,Penn St.-Berks,19,14,0,33
2015,1001,Catawba,31,17,0,48
2015,285,Holy Cross,11,17,0,28
2015,769,Western Caro.,22,31,0,53
2015,639,Siena,21,27,1,49
2015,363,Longwood,33,23,1,57
2015,725,Army West Point,23,27,1,51
2015,640,Simmons,18,15,0,33
2015,1126,Holy Family,19,15,0,34
2015,124,Catholic,17,17,0,34
2015,30175,Holy Names,9,45,0,54
2015,30127,Simon Fraser,17,30,0,47
2015,712,TCNJ,20,12,0,32
2015,8404,Hood,7,25,0,32
2015,641,Simpson,31,12,0,43
2015,35,Ashland,39,10,0,49
2015,364,Loras,19,19,0,38
2015,23624,Cazenovia,10,22,0,32
2015,770,Western Conn. St.,27,14,0,41
2015,30067,Morrisville St.,5,26,0,31
2015,36,Assumption,21,16,0,37
2015,286,Hope,29,11,0,40
2015,694,Tennessee,42,14,1,57
2015,771,Western Ill.,18,23,0,41
2015,14795,Cedar Crest,10,20,0,30
2015,30036,Mount Aloysius,18,19,0,37
2015,30160,Houghton,5,30,0,35
2015,196,East Carolina,16,37,0,53
2015,772,Western Ky.,34,12,1,47
2015,30124,Cedarville,35,25,0,60
2015,30128,Sioux Falls,32,23,0,55
2015,288,Houston,28,27,0,55
2015,8965,East Central,34,16,0,50
2015,691,Tennessee St.,11,37,0,48
2015,37,Auburn,49,9,1,59
2015,27901,Mount Ida,8,24,0,32
2015,125,Centenary (LA),7,26,0,33
2015,660,SIUE,43,16,0,59
2015,1182,Louisiana Col.,28,13,0,41
2015,287,Houston Baptist,13,32,0,45
2015,197,East Stroudsburg,21,20,0,41
2015,30033,Mount Mary,9,22,0,31
2015,12884,Centenary (NJ),19,20,0,39
2015,774,Western Mich.,25,26,0,51
2015,38,Augsburg,9,31,0,40
2015,198,East Tenn. St.,15,33,0,48
2015,692,Tennessee Tech,32,26,1,59
2015,290,Howard,14,29,0,43
2015,1245,Mount Olive,29,20,0,49
2015,126,Central (IA),34,10,2,46
2015,40,Augustana (IL),28,14,1,43
2015,642,Skidmore,14,22,0,36
2015,1062,East Tex. Baptist,34,6,1,41
2015,452,Mount Union,13,19,0,32
2015,366,Louisiana Tech,31,19,0,50
2015,1004,Central Ark.,35,19,1,55
2015,30090,Tex. A&M Int'l,25,25,0,50
2015,203,East. Mennonite,16,14,0,30
2015,643,Slippery Rock,15,23,0,38
2015,542,Pfeiffer,27,22,0,49
2015,41,Augustana (SD),53,9,2,64
2015,20220,MSOE,13,25,0,38
2015,1445,Western N.M.,23,30,0,53
2015,127,Central Conn. St.,31,12,1,44
2015,8968,Eastern,16,19,0,35
2015,644,Smith,10,18,0,28
2015,199,Tex. A&M-Commerce,29,24,0,53
2015,42,Aurora,37,8,0,45
2015,367,Louisville,30,17,1,48
2015,953,Austin,10,16,0,26
2015,2741,Howard Payne,10,27,0,37
2015,543,Philadelphia U.,19,25,0,44
2015,200,Eastern Conn. St.,29,8,1,38
2015,43,Austin Peay,9,37,0,46
2015,291,Humboldt St.,42,19,0,61
2015,645,Sonoma St.,42,19,2,63
2015,775,Western New Eng.,30,9,0,39
2015,371,Loyola Chicago,15,35,0,50
2015,129,Central Mich.,27,23,0,50
2015,292,Hunter,24,10,0,34
2015,646,South Ala.,38,11,1,50
2015,201,Eastern Ill.,21,27,0,48
2015,8567,Mt. St. Joseph,19,13,0,32
2015,648,South Carolina,37,20,1,58
2015,21830,Piedmont,17,14,0,31
2015,1468,Mt. St. Mary (NY),19,11,0,30
2015,202,Eastern Ky.,24,28,0,52
2015,1130,Huntingdon,20,18,0,38
2015,647,South Carolina St.,8,28,0,36
2015,450,Mt. St. Mary's,11,33,0,44
2015,44,Averett,35,5,1,41
2015,696,Tex. A&M-Kingsville,17,27,1,45
2015,370,Loyola Marymount,26,28,0,54
2015,451,Mt. St. Vincent,14,20,0,34
2015,650,South Dakota,28,25,1,54
2015,453,Muhlenberg,16,18,0,34
2015,204,Eastern Mich.,18,32,0,50
2015,1446,Western Ore.,21,28,0,49
2015,130,Central Mo.,47,14,2,63
2015,454,Murray St.,38,19,0,57
2015,30088,Tex. Permian Basin,8,43,0,51
2015,544,Pine Manor,2,22,0,24
2015,1009,Central Okla.,41,20,0,61
2015,649,South Dakota St.,23,29,0,52
2015,206,Eastern N.M.,16,34,0,50
2015,1315,Pitt.-Bradford,12,20,0,32
2015,30146,Azusa Pacific,29,26,0,55
2015,1064,Eastern Nazarene,1,5,0,6
2015,651,South Fla.,36,20,0,56
2015,703,Texas,37,15,1,53
2015,11839,Pitt.-Greensburg,16,21,0,37
2015,455,Muskingum,23,17,0,40
2015,1448,Western Wash.,30,18,0,48
2015,45,Babson,23,18,0,41
2015,654,Southeast Mo. St.,19,27,0,46
2015,546,Pitt.-Johnstown,7,30,0,37
2015,697,Texas A&M,38,18,1,57
2015,655,Southeastern La.,22,30,0,52
2015,1010,Central Wash.,20,23,0,43
2015,365,LSU,44,11,1,56
2015,1371,Southeastern Okla.,32,23,0,55
2015,777,Westfield St.,11,19,0,30
2015,132,Centre,14,18,0,32
2015,1314,Pittsburg St.,36,19,0,55
2015,1376,Southern Ark.,26,24,0,50
2015,94,Bakersfield,21,25,0,46
2015,1012,Chadron St.,15,35,0,50
2015,46,Baldwin Wallace,14,23,0,37
2015,30177,Lubbock Christian,35,11,0,46
2015,658,Southern Conn. St.,17,17,1,35
2015,133,Chaminade,10,38,0,48
2015,659,Southern Ill.,21,26,1,48
2015,1450,Westminster (MO),13,20,0,33
2015,134,Chapman,15,19,0,34
2015,545,Pittsburgh,35,20,1,56
2015,47,Ball St.,33,23,1,57
2015,1133,Husson,28,13,0,41
2015,372,Luther,38,6,0,44
2015,661,Southern Ind.,39,11,0,50
2015,1400,Texas Lutheran,37,5,1,43
2015,547,Plattsburgh St.,10,22,0,32
2015,548,Plymouth St.,13,21,0,34
2015,1451,Westminster (PA),22,14,0,36
2015,699,Texas Southern,25,16,1,42
2015,208,Eckerd,33,20,0,53
2015,373,Lycoming,14,20,0,34
2015,1013,Charleston (WV),38,14,0,52
2015,1066,Edgewood,18,25,0,43
2015,670,Texas St.,32,21,0,53
2015,662,Southern Me.,24,20,0,44
2015,374,Lynchburg,31,13,0,44
2015,700,Texas Tech,25,26,0,51
2015,778,Wheaton (IL),24,16,0,40
2015,30065,Lyndon St.,9,19,0,28
2015,209,Edinboro,23,14,1,38
2015,48,Charleston So.,31,28,0,59
2015,664,Southern Miss.,18,34,0,52
2015,779,Wheaton (MA),33,8,2,43
2015,20794,Lynn,20,26,0,46
2015,468,Southern N.H.,35,7,2,44
2015,376,Macalester,19,20,0,39
2015,377,MacMurray,18,17,0,35
2015,30152,Southern Nazarene,20,30,0,50
2015,701,Texas Woman's,28,22,2,52
2015,12799,Wheeling Jesuit,21,20,0,41
2015,380,Maine,22,22,0,44
2015,549,Pomona-Pitzer,17,23,0,40
2015,702,Texas-Arlington,27,28,0,55
2015,23121,Texas-Dallas,16,19,0,35
2015,8896,Wheelock,4,23,0,27
2015,49,Barry,32,15,0,47
2015,458,Charlotte,24,27,0,51
2015,15646,Barton,17,25,0,42
2015,294,Idaho St.,34,18,0,52
2015,58,Baruch,5,20,0,25
2015,550,Portland St.,16,35,0,51
2015,30137,Malone,4,31,0,35
2015,10972,Chatham,3,23,0,26
2015,30028,Texas-Tyler,45,3,2,50
2015,707,Thiel,16,16,0,32
2015,1318,Post,24,19,0,43
2015,781,Whittier,28,18,0,46
2015,2758,Thomas (ME),16,23,0,39
2015,50,Bates,14,20,0,34
2015,1192,Manchester,16,17,0,33
2015,1402,Thomas More,27,17,0,44
2015,553,Prairie View,9,27,0,36
2015,693,Chattanooga,35,13,1,49
2015,1403,Tiffin,23,23,0,46
2015,26520,Bay Path,10,22,0,32
2015,709,Toledo,24,32,0,56
2015,488,N.C. A&T,15,31,0,46
2015,21323,Chestnut Hill,9,30,0,39
2015,1454,Whitworth,31,12,0,43
2015,51,Baylor,38,15,1,54
2015,711,Towson,35,22,0,57
2015,381,Manhattan,26,20,0,46
2015,26107,Becker,20,15,0,35
2015,782,Wichita St.,34,23,0,57
2015,28749,Transylvania,13,23,0,36
2015,489,N.C. Central,18,27,0,45
2015,137,Chicago,15,19,0,34
2015,30002,Trevecca Nazarene,40,10,0,50
2015,382,Manhattanville,13,20,0,33
2015,52,Bellarmine,31,16,0,47
2015,783,Widener,25,9,0,34
2015,1320,Presbyterian,25,25,0,50
2015,491,N.C. Wesleyan,17,17,0,34
2015,665,Southern U.,16,14,0,30
2015,384,Mansfield,12,24,1,37
2015,95,Chico St.,29,22,0,51
2015,210,Elizabeth City St.,4,26,0,30
2015,1194,Maranatha Baptist,1,27,0,28
2015,667,Southern Utah,20,30,0,50
2015,8875,Chowan,26,14,0,40
2015,300,Ill. Wesleyan,36,10,0,46
2015,784,Wilkes,13,20,0,33
2015,30164,Southern Va.,0,25,0,25
2015,14927,Belmont,13,32,0,45
2015,554,Princeton,18,24,0,42
2015,8577,N.M. Highlands,22,28,0,50
2015,785,Willamette,16,22,0,38
2015,1379,Southern Vt.,11,14,0,25
2015,555,Principia,5,28,0,33
2015,139,Chris. Newport,30,7,2,39
2015,30037,Trine,39,5,0,44
2015,713,Trinity (CT),8,24,0,32
2015,302,Ill.-Chicago,24,22,0,46
2015,30192,Southern Wesleyan,24,22,0,46
2015,1015,Christian Bros.,10,41,0,51
2015,211,Elizabethtown,16,24,0,40
2015,1196,Marian (WI),14,24,0,38
2015,556,Providence,16,23,0,39
2015,30120,William Jewell,30,21,0,51
2015,2683,Belmont Abbey,22,23,0,45
2015,30050,Ill.-Springfield,32,22,0,54
2015,461,Nazareth,15,19,0,34
2015,17094,William Peace,23,15,1,39
2015,385,Marietta,12,22,0,34
2015,557,Puget Sound,4,36,0,40
2015,715,Trinity (TX),17,15,0,32
2015,462,Neb. Wesleyan,19,22,0,41
2015,23413,Trinity Washington,0,20,0,20
2015,212,Elmhurst,20,18,0,38
2015,53,Beloit,15,21,0,36
2015,386,Marist,28,26,0,54
2015,716,Troy,32,23,0,55
2015,30029,Purchase,10,14,0,24
2015,213,Elmira,8,16,0,24
2015,1156,Neb.-Kearney,19,28,0,47
2015,499,Truman,33,16,0,49
2015,54,Bemidji St.,18,30,0,48
2015,717,Tufts,42,0,2,44
2015,55,Benedict,11,27,0,38
2015,532,Elms,20,14,0,34
2015,463,Nebraska,34,21,1,56
2015,296,Benedictine (IL),31,11,0,42
2015,1254,Neumann,30,9,0,39
2015,1068,Elon,31,22,0,53
2015,559,Purdue,31,25,0,56
2015,301,Illinois,26,27,0,53
2015,214,Emerson,14,18,0,32
2015,1199,Mars Hill,12,23,0,35
2015,56,Bentley,11,19,0,30
2015,466,Nevada,16,37,0,53
2015,30193,Emmanuel (GA),9,27,0,36
2015,388,Marshall,35,15,0,50
2015,789,Williams,32,9,0,41
2015,215,Emmanuel (MA),20,17,0,37
2015,973,Berry,34,8,0,42
2015,297,Illinois Col.,14,19,0,33
2015,217,Emory,34,7,2,43
2015,719,Tulsa,36,18,0,54
2015,8597,Martin Luther,13,18,0,31
2015,11504,Queens (NC),12,33,0,45
2015,216,Emory & Henry,26,12,0,38
2015,12830,Tusculum,21,21,0,42
2015,30075,Mary,24,31,0,55
2015,1071,Emporia St.,35,20,0,55
2015,2755,Southwest Baptist,22,27,0,49
2015,560,Queens (NY),35,16,0,51
2015,299,Illinois St.,25,31,0,56
2015,389,Mary Baldwin,7,31,0,38
2015,8981,Endicott,18,19,0,37
2015,8736,Southwest Minn. St.,27,29,0,56
2015,1460,Wilmington (DE),32,18,0,50
2015,467,New England Col.,18,17,0,35
2015,561,Quincy,19,27,0,46
2015,303,Immaculata,18,20,0,38
2015,720,Tuskegee,13,20,0,33
2015,562,Quinnipiac,17,33,0,50
2015,8746,Southwestern (TX),18,21,0,39
2015,1203,Mary Hardin-Baylor,21,18,0,39
2015,1072,Erskine,19,23,0,42
2015,563,Radford,12,37,0,49
2015,1255,U New England,20,20,0,40
2015,8744,Southwestern Okla.,8,37,0,45
2015,1461,Wilmington (OH),7,31,0,38
2015,30058,Claflin,21,16,0,37
2015,218,Eureka,15,21,0,36
2015,470,New Haven,16,14,2,32
2015,564,Ramapo,28,14,1,43
2015,23260,Spalding,15,22,0,37
2015,12973,Wilson,20,14,0,34
2015,566,Randolph,17,19,0,36
2015,219,Evansville,10,45,0,55
2015,390,Mary Washington,21,14,0,35
2015,1462,Wingate,27,20,0,47
2015,9,UAB,32,19,0,51
2015,319,New Jersey City,5,33,0,38
2015,2743,Incarnate Word,12,39,0,51
2015,59,Bethany (WV),27,18,0,45
2015,220,Fairfield,25,22,1,48
2015,790,Winona St.,46,14,0,60
2015,222,Fairleigh Dickinson,16,20,0,36
2015,30038,Bethany Lutheran,13,23,0,36
2015,392,Maryland,27,27,0,54
2015,791,Winston-Salem,23,22,0,45
2015,306,Indiana,17,39,0,56
2015,565,Randolph-Macon,26,12,0,38
2015,1076,Fairmont St.,23,16,0,39
2015,27892,Farmingdale St.,22,15,0,37
2015,473,New Mexico,29,25,0,54
2015,307,Indiana (PA),19,24,0,43
2015,792,Winthrop,26,25,0,51
2015,60,Bethel (MN),28,15,0,43
2015,223,Fayetteville St.,16,14,0,30
2015,221,FDU-Florham,11,23,0,34
2015,472,New Mexico St.,46,14,1,61
2015,108,UC Davis,18,31,0,49
2015,305,Indiana St.,26,29,1,56
2015,395,Maryville (MO),18,32,0,50
2015,567,Redlands,19,21,0,40
2015,8911,Wis. Lutheran,12,27,0,39
2015,23157,Felician,18,23,0,41
2015,142,Claremont-M-S,27,14,0,41
2015,61,Bethune-Cookman,22,29,0,51
2015,476,New Rochelle,0,24,0,24
2015,143,Clarion,6,31,0,37
2015,396,Maryville (TN),12,25,0,37
2015,111,UC Riverside,39,17,0,56
2015,145,Clark (MA),2,26,0,28
2015,62,Binghamton,24,19,1,44
2015,1257,Newberry,31,22,0,53
2015,793,Wis.-Eau Claire,26,16,0,42
2015,144,Clark Atlanta,11,29,0,40
2015,568,Regis (CO),32,19,0,51
2015,224,Ferris St.,16,36,0,52
2015,397,Marywood,16,18,0,34
2015,112,UC San Diego,25,26,0,51
2015,21772,Newbury,20,14,0,34
2015,28593,Birmingham-So.,32,8,1,41
2015,399,Mass. Maritime,4,14,0,18
2015,104,UC Santa Barbara,19,35,0,54
2015,30054,Newman,15,39,0,54
2015,146,Clarkson,18,13,0,31
2015,795,Wis.-La Crosse,27,14,0,41
2015,309,Indianapolis,45,12,2,59
2015,569,Regis (MA),8,18,0,26
2015,482,Niagara,4,40,0,44
2015,30191,Spring Hill,36,7,0,43
2015,9754,UC-Colo. Springs,18,27,0,45
2015,798,Wis.-Oshkosh,30,12,0,42
2015,310,Iona,16,28,0,44
2015,225,Ferrum,23,17,0,40
2015,570,Rensselaer,20,15,0,35
2015,673,Springfield,18,21,0,39
2015,799,Wis.-Parkside,7,37,0,44
2015,30134,Black Hills St.,12,35,0,47
2015,148,Cleveland St.,23,29,0,52
2015,312,Iowa,19,40,0,59
2015,400,Massachusetts,15,28,0,43
2015,572,Rhode Island,3,41,0,44
2015,800,Wis.-Platteville,12,28,0,40
2015,722,Coast Guard,14,18,0,32
2015,483,Nicholls St.,26,22,0,48
2015,64,Blackburn,5,31,0,36
2015,128,UCF,48,7,1,56
2015,571,Rhode Island Col.,6,24,0,30
2015,149,Coastal Caro.,33,24,0,57
2015,311,Iowa St.,26,28,0,54
2015,28755,FGCU,23,30,0,53
2015,484,Nichols,11,18,0,29
2015,30083,Cobleskill St.,21,8,0,29
2015,593,St. Anselm,23,14,0,37
2015,773,McDaniel,29,12,0,41
2015,573,Rhodes,16,21,1,38
2015,150,Coe,24,16,0,40
2015,110,UCLA,45,10,1,56
2015,1079,Findlay,25,22,1,48
2015,801,Wis.-River Falls,23,22,0,45
2015,1023,Coker,24,27,0,51
2015,984,Bloomfield,25,21,1,47
2015,1014,Col. of Charleston,24,29,0,53
2015,802,Wis.-Stevens Point,15,24,0,39
2015,30032,Finlandia,8,34,0,42
2015,164,UConn,18,35,0,53
2015,803,Wis.-Stout,16,27,0,43
2015,65,Bloomsburg,26,16,0,42
2015,804,Wis.-Superior,16,18,0,34
2015,401,UMass Boston,6,24,0,30
2015,30173,Iowa Wesleyan,12,18,2,32
2015,805,Wis.-Whitewater,36,9,0,45
2015,596,St. Bonaventure,15,24,0,39
2015,151,Colby,11,18,0,29
2015,985,Bluefield St.,6,22,0,28
2015,227,Fitchburg St.,11,16,0,27
2015,597,St. Catherine,28,10,0,38
2015,796,Wisconsin,21,31,0,52
2015,987,Bluffton,26,16,0,42
2015,656,UMass Dartmouth,8,20,0,28
2015,153,Colgate,17,21,0,38
2015,598,St. Cloud St.,30,26,0,56
2015,308,IPFW,3,45,0,48
2015,66,Boise St.,12,42,0,54
2015,368,UMass Lowell,17,30,0,47
2015,806,Wittenberg,20,17,0,37
2015,313,Ithaca,21,14,0,35
2015,231,FIU,30,24,0,54
2015,67,Boston College,27,24,0,51
2015,30138,McKendree,15,33,0,48
2015,391,UMBC,22,27,0,49
2015,787,Wm. Paterson,30,13,1,44
2015,11403,Colo. Christian,23,29,0,52
2015,2699,IUPUI,33,18,0,51
2015,485,Norfolk St.,14,27,0,41
2015,393,UMES,7,32,0,39
2015,576,Rider,12,35,0,47
2015,1334,St. Edward's,27,22,0,49
2015,486,MCLA,16,22,0,38
2015,2707,UMKC,27,28,0,55
2015,229,Fla. Atlantic,37,17,2,56
2015,807,Wooster,15,21,0,36
2015,487,North Ala.,38,14,0,52
2015,314,Jackson St.,24,26,0,50
2015,68,Boston U.,17,27,0,44
2015,809,Worcester St.,22,15,0,37
2015,457,North Carolina,36,14,1,51
2015,69,Bowdoin,27,15,0,42
2015,537,UNC Pembroke,26,21,0,47
2015,9684,St. Elizabeth,13,23,0,36
2015,490,North Carolina St.,35,20,1,56
2015,402,McNeese St.,36,20,0,56
2015,70,Bowie St.,14,19,0,33
2015,492,North Central (IL),32,9,0,41
2015,316,Jacksonville,28,28,0,56
2015,808,WPI,34,9,2,45
2015,71,Bowling Green,20,28,0,48
2015,30039,North Central (MN),6,24,0,30
2015,379,Me.-Farmington,5,23,0,28
2015,577,Ripon,5,26,0,31
2015,494,North Dakota,12,43,0,55
2015,30040,Me.-Presque Isle,9,15,0,24
2015,18422,Rivier,14,20,0,34
2015,315,Jacksonville St.,38,17,0,55
2015,578,Roanoke,22,14,0,36
2015,23725,Medaille,13,22,0,35
2015,493,North Dakota St.,43,9,1,53
2015,579,Robert Morris,26,23,0,49
2015,2711,North Florida,31,28,0,59
2015,72,Bradley,22,32,0,54
2015,30052,North Georgia,47,7,2,56
2015,317,James Madison,47,8,1,56
2015,73,Brandeis,21,14,0,35
2015,581,Rochester (NY),29,13,0,42
2015,810,Wright St.,23,33,0,56
2015,30094,Brevard,10,26,0,36
2015,9223,North Greenville,22,20,0,42
2015,11416,Colorado Mesa,33,23,0,56
2015,496,North Park,6,32,0,38
2015,497,North Texas,19,31,0,50
2015,74,Bridgeport,15,33,0,48
2015,459,UNCG,25,22,0,47
2015,404,Memphis,19,34,0,53
2015,155,Colorado Mines,11,38,0,49
2015,233,Fla. Southern,19,32,0,51
2015,30092,Flagler,15,34,0,49
2015,460,UNCW,19,27,0,46
2015,235,Florida,50,6,1,57
2015,228,Florida A&M,18,37,1,56
2015,504,UNI,22,28,0,50
2015,580,Rochester Inst.,14,22,0,36
2015,156,Colorado St.,27,29,0,56
2015,75,Bridgewater (VA),11,27,0,38
2015,582,Rockford,8,32,0,40
2015,234,Florida St.,45,12,1,58
2015,1328,Rockhurst,28,22,0,50
2015,2720,Colorado St.-Pueblo,28,23,0,51
2015,813,Yale,11,23,0,34
2015,406,Mercer,37,22,0,59
2015,76,Bridgewater St.,20,16,0,36
2015,158,Columbia,16,28,0,44
2015,727,Union (NY),15,20,0,35
2015,12810,Northeastern St.,21,30,0,51
2015,230,Florida Tech,38,18,2,58
2015,11538,Fontbonne,30,11,0,41
2015,159,Columbus St.,24,26,0,50
2015,236,Fordham,36,18,1,55
2015,320,John Carroll,22,17,0,39
2015,407,Mercy,13,36,0,49
2015,814,Yeshiva,6,18,0,24
2015,9011,Fort Hays St.,26,27,0,53
2015,1028,Concord,34,19,0,53
2015,408,Mercyhurst,16,29,0,45
2015,2730,York (NY),3,22,0,25
2015,321,John Jay,14,21,0,35
2015,1083,Fort Lewis,16,31,0,47
2015,409,Meredith,15,19,0,34
2015,237,Fort Valley St.,12,24,0,36
2015,410,Merrimack,19,24,0,43
2015,601,St. John Fisher,28,14,0,42
2015,22626,Johnson & Wales (RI),22,16,0,38
2015,238,Framingham St.,13,20,0,33
2015,411,Messiah,31,9,0,40
2015,583,Roger Williams,14,17,0,31
2015,603,St. John's (NY),28,17,1,46
2015,1085,Francis Marion,25,22,0,47
2015,412,Methodist,19,19,0,38
2015,30069,Franciscan,1,33,0,34
2015,8687,St. Joseph (CT),15,18,0,33
2015,815,York (PA),23,19,0,42
2015,30180,Rogers St.,14,31,0,45
2015,239,Frank. & Marsh.,23,11,0,34
2015,323,Johnson C. Smith,12,18,0,30
2015,30072,St. Joseph's (Brkln),23,20,0,43
2015,2694,Franklin,21,13,0,34
2015,78,Brockport,20,18,0,38
2015,502,Northern Colo.,17,25,1,43
2015,30153,Union (TN),31,19,0,50
2015,324,Johnson St.,9,15,0,24
2015,584,Rollins,38,13,0,51
2015,241,Franklin Pierce,8,19,0,27
2015,413,Metro St.,44,16,0,60
2015,604,St. Joseph's (IN),18,23,0,41
2015,242,Fredonia,13,18,0,31
2015,30154,Young Harris,31,18,0,49
2015,79,Brooklyn,21,20,0,41
2015,325,Juniata,8,28,0,36
2015,1340,St. Joseph's (L.I.),18,18,0,36
2015,503,Northern Ill.,28,25,0,53
2015,80,Brown,13,21,0,34
2015,585,Rose-Hulman,21,13,0,34
2015,326,Kalamazoo,9,23,0,32
2015,605,St. Joseph's (ME),27,13,0,40
2015,465,UNLV,25,30,0,55
2015,607,St. Lawrence,15,13,0,28
2015,817,Youngstown St.,18,31,0,49
2015,15882,Rosemont,4,27,0,31
2015,259,Rowan,38,8,0,46
2015,728,Upper Iowa,23,30,0,53
2015,586,Rust,2,12,0,14
2015,328,Kansas,38,13,1,52
2015,610,St. Mary's (CA),21,32,0,53
2015,414,Miami (OH),32,24,0,56
2015,8688,St. Mary's (IN),23,14,0,37
2015,587,Rutgers,29,20,0,49
2015,96,Fresno St.,40,14,1,55
2015,505,Northern Ky.,6,42,0,48
2015,30104,Urbana,9,36,0,45
2015,730,Ursinus,13,20,0,33
2015,30140,Ursuline,10,23,0,33
2015,10411,USC Upstate,43,8,1,52
2015,329,Kean,28,12,3,43
2015,28594,USciences,10,28,0,38
2015,695,UT Martin,24,26,0,50
2015,162,Concordia (NY),10,24,0,34
2015,330,Keene St.,16,19,0,35
2015,418,Michigan,51,6,1,58
2015,24400,Concordia (TX),8,29,0,37
2015,1157,Kennesaw St.,32,20,0,52
2015,732,Utah,34,17,1,52
2015,416,Michigan St.,19,36,0,55
2015,160,Concordia Chicago,19,23,0,42
2015,331,Kent St.,41,13,0,54
2015,419,Middle Tenn.,22,29,0,51
2015,243,Frostburg St.,24,12,0,36
2015,1036,Concordia Wisconsin,28,15,0,43
2015,731,Utah St.,19,36,0,55
2015,334,Kentucky,29,24,1,54
2015,161,Concordia-M'head,13,24,0,37
2015,420,Middlebury,20,11,0,31
2015,1266,Northern St.,33,22,0,55
2015,244,Furman,31,25,0,56
2015,30024,Utah Valley,18,41,0,59
2015,332,Kentucky St.,21,16,0,37
2015,1267,Northland,9,27,0,36
2015,9081,Concordia-St. Paul,16,37,0,53
2015,335,Kenyon,29,11,0,40
2015,704,UTEP,14,39,0,53
2015,507,Northwest Mo. St.,26,24,0,50
2015,1159,Keuka,18,9,0,27
2015,30047,Keystone,13,19,0,32
2015,253,Ga. Southern,12,39,0,51
2015,1274,Northwest Nazarene,9,37,0,46
2015,165,Coppin St.,5,31,0,36
2015,1097,Ga. Southwestern,15,33,0,48
2015,30051,King (TN),18,27,0,45
2015,167,Cornell,17,24,0,41
2015,509,Northwestern,28,21,1,50
2015,166,Cornell College,30,8,0,38
2015,245,Gallaudet,4,33,0,37
2015,246,Gannon,29,16,0,45
2015,336,King's (PA),17,14,0,31
2015,1092,Gardner-Webb,15,35,0,50
2015,30084,Geneva,19,19,0,38
2015,30178,Northwestern Okla.,23,26,0,49
2015,508,Northwestern St.,36,18,0,54
2015,30031,Northwestern-St. Paul,15,28,0,43
2015,510,Northwood (MI),16,25,0,41
2015,511,Norwich,10,19,0,29
2015,513,Notre Dame,40,13,1,54
2015,8600,Notre Dame (MD),5,23,0,28
2015,30126,Notre Dame (OH),27,28,0,55
2015,30056,Notre Dame de Namur,24,29,0,53
2015,24639,Nova Southeastern,21,25,0,46
2015,1277,Nyack,11,32,0,43
2015,477,NYIT,28,22,0,50
