year,team_id,team_name,wins,losses,ties,total_games
2004,477,NYIT,5,13,0,18
2004,420,Middlebury,24,8,0,32
2004,336,King's (PA),39,10,0,49
2004,733,Utica,18,20,0,38
2004,166,Cornell College,6,33,0,39
2004,81,Bryant,25,15,0,40
2004,587,Rutgers,25,29,1,55
2004,26172,A&M-Corpus Chris,39,21,0,60
2004,337,Knox,10,22,1,33
2004,1346,St. Mary's (TX),46,12,0,58
2004,1094,George Fox,4,32,0,36
2004,588,Rutgers-Camden,36,11,0,47
2004,706,UTSA,37,17,0,54
2004,2,Abilene Christian,20,30,0,50
2004,248,George Mason,28,32,0,60
2004,589,Rutgers-Newark,17,22,0,39
2004,1222,Midwestern St.,31,16,0,47
2004,614,St. Norbert,12,19,0,31
2004,249,George Washington,1,5,1,7
2004,339,Kutztown,31,19,0,50
2004,169,Creighton,44,17,1,62
2004,422,Miles,16,10,0,26
2004,11276,S.C. Aiken,31,29,0,60
2004,514,Oakland,11,42,0,53
2004,615,St. Olaf,7,26,0,33
2004,333,Ky. Wesleyan,4,36,0,40
2004,1163,La Roche,9,14,0,23
2004,745,Va. Wesleyan,22,21,0,43
2004,102,Sacramento St.,32,28,0,60
2004,1278,Oakland City,13,15,11,39
2004,101,CSUN,35,19,0,54
2004,616,St. Paul's,0,22,0,22
2004,340,La Salle,10,31,0,41
2004,515,Oberlin,0,16,0,16
2004,506003,Georgetown (KY),0,2,0,2
2004,83,Bucknell,14,26,0,40
2004,734,Valdosta St.,30,35,0,65
2004,84,Buena Vista,13,23,0,36
2004,516,Occidental,11,21,0,32
2004,257,Georgia,55,17,0,72
2004,590,Sacred Heart,11,32,1,44
2004,86,Buffalo,25,23,0,48
2004,423,Millersville,16,25,1,42
2004,1096,Georgia College,33,18,0,51
2004,85,Buffalo St.,26,14,0,40
2004,929,Adams St.,8,41,0,49
2004,519,Ohio,20,31,0,51
2004,254,Georgia St.,18,33,0,51
2004,87,Butler,18,39,1,58
2004,255,Georgia Tech,47,19,0,66
2004,77,BYU,34,18,0,52
2004,3,Adelphi,8,7,1,16
2004,341,La Verne,27,14,0,41
2004,9004,Georgian Court,25,15,0,40
2004,2685,BYU-Hawaii,12,23,0,35
2004,517,Ohio Northern,17,21,0,38
2004,258,Gettysburg,22,13,0,35
2004,88,Cabrini,33,12,0,45
2004,1098,Glenville St.,0,2,0,2
2004,170,Curry,36,8,0,44
2004,1305,Cairn,3,17,0,20
2004,518,Ohio St.,35,25,0,60
2004,8366,Goldey-Beacom,16,23,0,39
2004,1059,D'Youville,18,8,0,26
2004,105,Cal Lutheran,20,19,0,39
2004,735,Valparaiso,21,34,0,55
2004,4,Adrian,9,21,0,30
2004,15207,Ohio Valley,7,29,2,38
2004,671,La.-Lafayette,60,8,0,68
2004,591,Saginaw Valley,31,19,1,51
2004,520,Ohio Wesleyan,28,15,0,43
2004,498,La.-Monroe,13,48,0,61
2004,11324,Agnes Scott,5,29,0,34
2004,594,Saint Augustine's,10,17,0,27
2004,618,St. Scholastica,40,8,0,48
2004,1099,Gordon,13,19,0,32
2004,342,Lafayette,10,32,0,42
2004,424,Millikin,24,21,0,45
2004,90,Cal Poly,22,28,0,50
2004,1162,LaGrange,21,24,0,45
2004,2746,Lake Erie,5,25,0,30
2004,595,Saint Benedict,29,7,0,36
2004,1044,Dallas,13,18,0,31
2004,600,Saint Francis (PA),8,33,0,41
2004,24342,Okla. Panhandle,21,39,0,60
2004,92,Cal St. Dom. Hills,33,22,1,56
2004,522,Oklahoma,45,22,1,68
2004,98,Cal St. East Bay,10,3,1,14
2004,503905,Oklahoma City,2,3,0,5
2004,344,Lake Forest,28,13,0,41
2004,521,Oklahoma St.,27,28,0,55
2004,606,Saint Joseph's,21,29,0,50
2004,97,Cal St. Fullerton,18,34,0,52
2004,738,Vermont,9,34,2,45
2004,620,St. Thomas (MN),46,4,0,50
2004,345,Lake Superior St.,31,33,0,64
2004,524,Old Westbury,7,19,0,26
2004,608,Saint Leo,36,22,0,58
2004,739,Villanova,32,26,0,58
2004,5,Akron,26,25,0,51
2004,1164,Lakeland,16,22,0,38
2004,433,Ole Miss,15,37,0,52
2004,609,Saint Louis,16,45,0,61
2004,2691,Daniel Webster,1,21,0,22
2004,746,Virginia,38,26,0,64
2004,743,Virginia St.,20,24,0,44
2004,1343,Saint Martin's,10,34,0,44
2004,742,Virginia Tech,36,23,0,59
2004,612,Saint Mary's (MN),23,15,0,38
2004,744,Virginia Union,5,21,0,26
2004,172,Dartmouth,17,20,0,37
2004,525,Olivet,19,15,0,34
2004,613,Saint Michael's,21,17,0,38
2004,426,Millsaps,24,20,0,44
2004,10,Ala.-Huntsville,48,11,0,59
2004,261,Grambling,3,44,0,47
2004,617,Saint Peter's,11,22,0,33
2004,1348,St. Thomas Aquinas,3,10,0,13
2004,464,Omaha,47,11,0,58
2004,1347,Saint Rose,18,20,0,38
2004,1104,Grand Canyon,28,24,0,52
2004,174,Davis & Elkins,8,29,0,37
2004,748,Wagner,22,26,1,49
2004,93,Cal St. San B'dino,15,39,0,54
2004,262,Grand Valley St.,36,8,0,44
2004,175,Dayton,14,35,0,49
2004,427,Minn. Duluth,25,23,0,48
2004,8,Alabama,45,20,0,65
2004,529,Oregon,42,21,0,63
2004,103,Cal St. Stanislaus,20,37,0,57
2004,1050,Defiance,22,19,1,42
2004,674,Stanford,49,19,0,68
2004,528,Oregon St.,44,28,0,72
2004,19117,Salem Int'l,17,16,2,35
2004,995,Caldwell,45,7,0,52
2004,383,Minn. St. Mankato,27,28,0,55
2004,6,Alabama A&M,24,39,0,63
2004,750,Wartburg,32,8,0,40
2004,180,Delaware,29,24,1,54
2004,794,Green Bay,8,29,0,37
2004,107,California,53,13,0,66
2004,751,Wash. & Jeff.,14,21,0,35
2004,1240,Minn. St. Moorhead,36,17,0,53
2004,7,Alabama St.,14,38,0,52
2004,106,California (PA),31,11,0,42
2004,675,Staten Island,18,14,1,33
2004,11062,Green Mountain,12,26,0,38
2004,27854,Minn.-Crookston,9,33,0,42
2004,1167,Lander,29,31,0,60
2004,263,Greensboro,14,18,2,34
2004,1111,Greenville,5,31,0,36
2004,530,Oswego St.,5,31,0,36
2004,114,Calvin,19,15,0,34
2004,996,Cameron,9,34,0,43
2004,2814,Washburn,32,25,0,57
2004,178,Delaware St.,41,22,0,63
2004,264,Grinnell,8,20,0,28
2004,756,Washington,40,19,0,59
2004,531,Otterbein,17,21,0,38
2004,115,Campbell,20,36,0,56
2004,1029,Washington Adventist,8,23,0,31
2004,1289,Ouachita Baptist,14,37,0,51
2004,676,Stephen F. Austin,23,27,0,50
2004,753,Washington Col.,8,21,1,30
2004,8486,Lasell,20,16,0,36
2004,179,Delaware Valley,8,25,0,33
2004,23008,Ozarks (AR),19,18,0,37
2004,428,Minnesota,33,23,0,56
2004,622,Salisbury,40,8,0,48
2004,265,Grove City,14,9,0,23
2004,14,Albany (NY),34,18,0,52
2004,623,Salve Regina,22,19,1,42
2004,181,Delta St.,36,16,0,52
2004,116,Canisius,23,30,0,53
2004,39,GRU Augusta,15,37,0,52
2004,16142,Misericordia,32,12,0,44
2004,348,Lawrence,19,15,0,34
2004,624,Sam Houston St.,29,23,0,52
2004,13,Albany St. (GA),24,39,1,64
2004,182,Denison,10,26,0,36
2004,1112,Guilford,9,27,0,36
2004,625,Samford,28,33,0,61
2004,429,Mississippi Col.,22,14,0,36
2004,349,Le Moyne,34,10,0,44
2004,266,Gust. Adolphus,21,17,0,38
2004,678,Stetson,45,17,0,62
2004,12399,Gwynedd Mercy,6,15,0,21
2004,627,San Diego,18,32,0,50
2004,430,Mississippi St.,39,26,0,65
2004,2798,Albertus Magnus,6,18,0,24
2004,351,Lebanon Valley,16,20,0,36
2004,176,DePaul,30,31,1,62
2004,267,Hamilton,6,23,0,29
2004,432,Mississippi Val.,34,17,0,51
2004,177,DePauw,14,23,0,37
2004,15,Albion,23,13,0,36
2004,268,Hamline,26,16,0,42
2004,20,DeSales,19,14,0,33
2004,626,San Diego St.,37,23,0,60
2004,13302,Lees-McRae,11,33,0,44
2004,21852,Stevenson,9,20,0,29
2004,184,Detroit,18,32,0,50
2004,628,San Fran. St.,41,25,0,66
2004,352,Lehigh,40,17,2,59
2004,533,Pace,26,16,0,42
2004,680,Stillman,12,18,0,30
2004,434,Missouri,29,26,0,55
2004,270,Hampton,31,23,0,54
2004,279,Lehman,10,15,0,25
2004,534,Pacific,36,23,0,59
2004,117,Capital,23,17,0,40
2004,16,Albright,18,17,0,35
2004,1115,Hanover,9,21,0,30
2004,2751,Pacific (OR),22,18,0,40
2004,630,San Jose St.,16,35,0,51
2004,435,Missouri S&T,41,14,0,55
2004,271,Hardin-Simmons,10,27,1,38
2004,681,Stockton,18,15,1,34
2004,1297,Pacific Lutheran,28,10,0,38
2004,631,Santa Clara,30,23,0,53
2004,535,Paine,1,26,0,27
2004,17,Alcorn,13,23,0,36
2004,755,Washington-St. Louis,33,5,0,38
2004,669,Missouri St.,29,29,0,58
2004,1170,Lenoir-Rhyne,38,16,0,54
2004,185,Dickinson,12,20,0,32
2004,118,Carleton,14,24,0,38
2004,682,Stonehill,1,0,0,1
2004,24317,Lesley,14,16,0,30
2004,8490,LeTourneau,7,32,0,39
2004,934,Alderson Broaddus,30,12,0,42
2004,354,Lewis,45,13,0,58
2004,18,Alfred,10,17,0,27
2004,683,Stony Brook,30,33,0,63
2004,22235,Lewis & Clark,8,31,0,39
2004,120,Carroll (WI),8,24,0,32
2004,684,Suffolk,21,15,0,36
2004,1000,Carson-Newman,40,12,0,52
2004,19,Allegheny,23,16,0,39
2004,1390,Sul Ross St.,9,27,0,36
2004,355,Liberty,19,44,0,63
2004,121,Carthage,25,11,0,36
2004,1174,Limestone,23,25,0,48
2004,272,Hartford,14,24,0,38
2004,632,Savannah St.,0,28,0,28
2004,757,Wayne St. (MI),36,22,0,58
2004,273,Hartwick,10,24,0,34
2004,122,Case,11,20,0,31
2004,168,SUNY Cortland,37,9,0,46
2004,1355,Schreiner,9,17,0,26
2004,1433,Wayne St. (NE),21,23,0,44
2004,123,Castleton,17,17,1,35
2004,398,MIT,3,23,1,27
2004,275,Harvard,22,20,1,43
2004,633,Scranton,17,16,0,33
2004,247,SUNY Geneseo,28,17,0,45
2004,1434,Waynesburg,7,20,0,27
2004,540,Penn,10,31,1,42
2004,1001,Catawba,28,29,0,57
2004,1356,Seattle,29,17,0,46
2004,124,Catholic,15,16,2,33
2004,23624,Cazenovia,24,15,0,39
2004,635,Seton Hall,46,19,0,65
2004,1176,Lincoln Memorial,31,28,0,59
2004,276,Haverford,10,23,0,33
2004,478,SUNY Maritime,2,13,8,23
2004,759,Webster,23,13,0,36
2004,475,SUNY New Paltz,6,28,1,35
2004,14795,Cedar Crest,11,17,0,28
2004,277,Hawaii,28,33,0,61
2004,761,Wells,0,24,0,24
2004,526,SUNY Oneonta,28,17,0,45
2004,762,Wentworth,15,15,0,30
2004,539,Penn St.,25,33,0,58
2004,1179,Linfield,37,9,0,46
2004,2697,Hawaii Hilo,25,17,0,42
2004,9500,SUNY Poly,20,19,0,39
2004,652,Sewanee,20,21,0,41
2004,28600,Lipscomb,18,34,0,52
2004,21,Alma,39,9,0,48
2004,125,Centenary (LA),36,28,0,64
2004,636,Shaw,23,18,0,41
2004,2696,Hawaii Pacific,22,21,0,43
2004,9012,Mo. Southern St.,19,27,0,46
2004,361,LIU Brooklyn,27,28,0,55
2004,552,SUNY Potsdam,3,29,0,32
2004,685,Susquehanna,18,13,0,31
2004,12884,Centenary (NJ),21,17,0,38
2004,362,LIU Post,12,8,0,20
2004,686,Swarthmore,10,22,0,32
2004,763,Wesley,16,17,0,33
2004,25719,Penn St.-Altoona,18,19,0,37
2004,126,Central (IA),35,9,0,44
2004,538,Penn St.-Behrend,11,26,0,37
2004,278,Heidelberg,3,33,0,36
2004,938,Alvernia,8,29,0,37
2004,764,Wesleyan (CT),11,20,0,31
2004,637,Shenandoah,10,23,0,33
2004,9013,Mo. Western St.,31,19,0,50
2004,1004,Central Ark.,17,27,0,44
2004,359,Livingstone,3,21,0,24
2004,28746,Alverno,13,15,7,35
2004,14718,Wesleyan (GA),9,30,0,39
2004,688,Syracuse,25,29,0,54
2004,127,Central Conn. St.,9,41,0,50
2004,360,Lock Haven,27,17,0,44
2004,1123,Henderson St.,34,13,0,47
2004,358,West Ala.,11,35,0,46
2004,10870,Shepherd,24,22,0,46
2004,99,Long Beach St.,51,13,0,64
2004,1124,Hendrix,12,30,0,42
2004,765,West Chester,14,25,1,40
2004,1332,Dominican (IL),11,29,1,41
2004,436,Mo.-St. Louis,27,27,0,54
2004,638,Shippensburg,48,6,0,54
2004,363,Longwood,37,13,0,50
2004,11740,West Florida,36,20,0,56
2004,437,Molloy,5,10,0,15
2004,8398,Hilbert,12,14,0,26
2004,364,Loras,13,26,0,39
2004,766,West Ga.,21,38,0,59
2004,280,Hillsdale,16,18,1,35
2004,439,Monmouth,19,23,0,42
2004,1438,West Liberty,37,14,0,51
2004,689,Tampa,33,14,0,47
2004,281,Hiram,6,21,0,27
2004,8956,Dominican (NY),16,27,0,43
2004,129,Central Mich.,32,19,0,51
2004,542,Pfeiffer,15,32,3,50
2004,438,Monmouth (IL),14,20,0,34
2004,543,Philadelphia U.,4,6,0,10
2004,130,Central Mo.,37,19,0,56
2004,2692,Dowling,4,13,1,18
2004,22,American Int'l,20,24,0,44
2004,1009,Central Okla.,21,20,0,41
2004,14901,West Va. Tech,2,6,16,24
2004,1395,Tarleton St.,30,17,0,47
2004,205,Mont. St. Billings,27,28,0,55
2004,24,Amherst,13,14,0,27
2004,1182,Louisiana Col.,26,8,0,34
2004,21830,Piedmont,24,16,0,40
2004,9630,West Va. Wesleyan,46,17,0,63
2004,939,Anderson (IN),12,24,0,36
2004,189,Drake,30,24,0,54
2004,283,Hofstra,38,21,0,59
2004,13028,Anderson (SC),24,36,0,60
2004,712,TCNJ,22,13,1,36
2004,366,Louisiana Tech,27,33,0,60
2004,190,Drew,21,13,0,34
2004,544,Pine Manor,25,14,0,39
2004,1010,Central Wash.,22,21,0,43
2004,639,Siena,14,33,1,48
2004,1315,Pitt.-Bradford,22,8,0,30
2004,132,Centre,16,18,0,34
2004,25,Angelo St.,47,11,0,58
2004,191,Drexel,15,35,2,52
2004,11839,Pitt.-Greensburg,2,12,0,14
2004,367,Louisville,41,19,0,60
2004,26,Anna Maria,19,20,0,39
2004,285,Holy Cross,12,28,0,40
2004,27,Appalachian St.,22,39,0,61
2004,690,Temple,30,18,0,48
2004,192,Dubuque,12,24,0,36
2004,1126,Holy Family,25,22,0,47
2004,371,Loyola Chicago,31,29,0,60
2004,966,Arcadia,29,10,0,39
2004,694,Tennessee,55,16,0,71
2004,133,Chaminade,13,32,0,45
2004,29,Arizona,55,6,0,61
2004,134,Chapman,36,11,0,47
2004,1314,Pittsburg St.,44,23,0,67
2004,8404,Hood,16,11,0,27
2004,691,Tennessee St.,16,41,0,57
2004,1439,West Virginia St.,23,17,0,40
2004,545,Pittsburgh,21,36,0,57
2004,28,Arizona St.,33,31,0,64
2004,1013,Charleston (WV),9,18,40,67
2004,641,Simpson,33,7,0,40
2004,286,Hope,20,17,0,37
2004,547,Plattsburgh St.,20,22,0,42
2004,692,Tennessee Tech,44,25,0,69
2004,548,Plymouth St.,15,16,0,31
2004,370,Loyola Marymount,33,13,0,46
2004,8411,Ark.-Monticello,36,13,0,49
2004,288,Houston,39,25,0,64
2004,196,East Carolina,47,24,1,72
2004,48,Charleston So.,19,38,0,57
2004,2678,Ark.-Pine Bluff,8,20,0,28
2004,365,LSU,57,12,0,69
2004,442,Montclair St.,34,10,0,44
2004,770,Western Conn. St.,26,16,0,42
2004,8965,East Central,11,23,0,34
2004,458,Charlotte,23,29,0,52
2004,10972,Chatham,7,12,0,19
2004,443,Moravian,40,6,0,46
2004,693,Chattanooga,45,25,0,70
2004,31,Arkansas,18,40,0,58
2004,197,East Stroudsburg,14,23,1,38
2004,444,Morehead St.,12,35,0,47
2004,21323,Chestnut Hill,10,15,0,25
2004,696,Tex. A&M-Kingsville,31,24,0,55
2004,290,Howard,12,28,0,40
2004,198,East Tenn. St.,29,34,0,63
2004,372,Luther,18,21,0,39
2004,771,Western Ill.,28,29,0,57
2004,373,Lycoming,17,15,0,32
2004,1062,East Tex. Baptist,41,5,0,46
2004,374,Lynchburg,31,11,1,43
2004,772,Western Ky.,35,23,0,58
2004,2741,Howard Payne,21,13,0,34
2004,703,Texas,24,25,0,49
2004,660,SIUE,35,19,0,54
2004,446,Morgan St.,16,27,0,43
2004,481,Polytechnic (NY),17,5,6,28
2004,697,Texas A&M,33,22,0,55
2004,203,East. Mennonite,11,20,0,31
2004,774,Western Mich.,32,26,0,58
2004,549,Pomona-Pitzer,0,27,0,27
2004,505260,Texas Col.,1,3,0,4
2004,642,Skidmore,8,22,1,31
2004,291,Humboldt St.,53,15,0,68
2004,8968,Eastern,15,16,0,31
2004,1400,Texas Lutheran,29,11,1,41
2004,1445,Western N.M.,45,13,0,58
2004,643,Slippery Rock,15,27,0,42
2004,292,Hunter,18,16,0,34
2004,200,Eastern Conn. St.,21,18,0,39
2004,137,Chicago,29,11,0,40
2004,550,Portland St.,19,36,0,55
2004,775,Western New Eng.,33,11,0,44
2004,644,Smith,34,6,0,40
2004,1130,Huntingdon,20,14,0,34
2004,201,Eastern Ill.,21,35,0,56
2004,1318,Post,27,18,1,46
2004,20794,Lynn,35,19,1,55
2004,1446,Western Ore.,18,28,0,46
2004,553,Prairie View,21,28,0,49
2004,95,Chico St.,27,27,0,54
2004,947,Arkansas Tech,15,26,0,41
2004,1133,Husson,22,14,0,36
2004,202,Eastern Ky.,42,17,0,59
2004,645,Sonoma St.,24,37,0,61
2004,8875,Chowan,27,16,0,43
2004,699,Texas Southern,11,37,0,48
2004,1320,Presbyterian,48,13,0,61
2004,33,Armstrong,42,9,0,51
2004,376,Macalester,7,27,1,35
2004,139,Chris. Newport,36,7,0,43
2004,648,South Carolina,28,24,0,52
2004,204,Eastern Mich.,19,30,0,49
2004,725,Army,27,22,0,49
2004,1015,Christian Bros.,15,26,0,41
2004,377,MacMurray,20,21,0,41
2004,554,Princeton,24,23,0,47
2004,647,South Carolina St.,14,29,0,43
2004,206,Eastern N.M.,11,36,0,47
2004,380,Maine,28,23,0,51
2004,670,Texas St.,37,20,0,57
2004,1448,Western Wash.,22,23,0,45
2004,556,Providence,34,20,1,55
2004,1064,Eastern Nazarene,3,28,0,31
2004,650,South Dakota,23,38,0,61
2004,378,Maine Maritime,3,29,2,34
2004,777,Westfield St.,11,19,1,31
2004,557,Puget Sound,15,21,0,36
2004,700,Texas Tech,22,36,0,58
2004,449,Mount Holyoke,9,22,1,32
2004,35,Ashland,27,17,0,44
2004,27901,Mount Ida,7,21,0,28
2004,36,Assumption,20,24,0,44
2004,701,Texas Woman's,40,15,0,55
2004,300,Ill. Wesleyan,31,10,0,41
2004,702,Texas-Arlington,24,24,1,49
2004,1450,Westminster (MO),1,25,0,26
2004,1451,Westminster (PA),28,13,0,41
2004,23121,Texas-Dallas,25,15,0,40
2004,208,Eckerd,14,36,1,51
2004,302,Ill.-Chicago,42,23,0,65
2004,1192,Manchester,14,22,0,36
2004,1066,Edgewood,25,18,0,43
2004,778,Wheaton (IL),5,27,0,32
2004,559,Purdue,32,25,0,57
2004,209,Edinboro,8,28,0,36
2004,779,Wheaton (MA),33,12,1,46
2004,381,Manhattan,16,33,0,49
2004,12799,Wheeling Jesuit,29,22,1,52
2004,382,Manhattanville,18,16,0,34
2004,649,South Dakota St.,23,36,0,59
2004,1245,Mount Olive,14,35,0,49
2004,8896,Wheelock,2,30,4,36
2004,210,Elizabeth City St.,18,9,0,27
2004,651,South Fla.,60,14,0,74
2004,211,Elizabethtown,11,21,0,32
2004,452,Mount Union,25,16,0,41
2004,384,Mansfield,27,15,0,42
2004,2753,Southampton,6,12,0,18
2004,781,Whittier,0,2,0,2
2004,11504,Queens (NC),13,26,0,39
2004,707,Thiel,12,23,0,35
2004,1194,Maranatha Baptist,3,23,0,26
2004,560,Queens (NY),8,9,0,17
2004,37,Auburn,42,18,0,60
2004,1454,Whitworth,29,8,0,37
2004,2758,Thomas (ME),22,19,0,41
2004,561,Quincy,29,27,0,56
2004,1402,Thomas More,17,12,4,33
2004,8580,City Tech,0,16,0,16
2004,20220,MSOE,7,28,0,35
2004,782,Wichita St.,38,26,0,64
2004,1196,Marian (WI),20,21,0,41
2004,562,Quinnipiac,23,28,0,51
2004,1403,Tiffin,39,15,0,54
2004,783,Widener,23,13,0,36
2004,385,Marietta,18,19,0,37
2004,654,Southeast Mo. St.,16,36,0,52
2004,500990,Claflin,0,3,0,3
2004,38,Augsburg,9,27,0,36
2004,655,Southeastern La.,23,25,0,48
2004,212,Elmhurst,15,22,1,38
2004,563,Radford,31,32,0,63
2004,709,Toledo,21,34,0,55
2004,386,Marist,11,43,0,54
2004,1371,Southeastern Okla.,30,19,0,49
2004,8567,Mt. St. Joseph,19,17,0,36
2004,213,Elmira,14,10,0,24
2004,564,Ramapo,35,8,0,43
2004,1376,Southern Ark.,26,19,0,45
2004,40,Augustana (IL),36,9,0,45
2004,566,Randolph,1,26,0,27
2004,1468,Mt. St. Mary (NY),11,13,1,25
2004,532,Elms,27,9,0,36
2004,565,Randolph-Macon,16,18,0,34
2004,1199,Mars Hill,12,47,0,59
2004,301,Illinois,45,21,1,67
2004,567,Redlands,28,9,1,38
2004,658,Southern Conn. St.,11,31,0,42
2004,450,Mt. St. Mary's,13,30,0,43
2004,41,Augustana (SD),35,21,0,56
2004,659,Southern Ill.,45,17,0,62
2004,1068,Elon,33,23,1,57
2004,568,Regis (CO),28,14,0,42
2004,661,Southern Ind.,26,24,0,50
2004,451,Mt. St. Vincent,12,24,0,36
2004,42,Aurora,29,11,1,41
2004,388,Marshall,31,27,0,58
2004,711,Towson,35,28,0,63
2004,784,Wilkes,17,20,0,37
2004,662,Southern Me.,33,11,1,45
2004,214,Emerson,25,16,0,41
2004,8597,Martin Luther,13,25,0,38
2004,785,Willamette,16,23,0,39
2004,453,Muhlenberg,21,12,0,33
2004,664,Southern Miss.,33,26,0,59
2004,28749,Transylvania,21,10,6,37
2004,468,Southern N.H.,19,17,0,36
2004,43,Austin Peay,18,37,0,55
2004,569,Regis (MA),9,27,0,36
2004,297,Illinois Col.,15,18,0,33
2004,215,Emmanuel (MA),16,19,0,35
2004,570,Rensselaer,22,12,0,34
2004,217,Emory,37,12,0,49
2004,44,Averett,20,22,0,42
2004,142,Claremont-M-S,25,9,0,34
2004,299,Illinois St.,33,19,1,53
2004,572,Rhode Island,15,31,0,46
2004,216,Emory & Henry,28,14,0,42
2004,143,Clarion,12,18,0,30
2004,303,Immaculata,8,16,0,24
2004,505850,William Carey,1,1,0,2
2004,145,Clark (MA),13,17,0,30
2004,571,Rhode Island Col.,21,15,1,37
2004,389,Mary Baldwin,21,19,0,40
2004,144,Clark Atlanta,14,21,0,35
2004,573,Rhodes,7,19,0,26
2004,1071,Emporia St.,43,18,0,61
2004,1020,Clarke,25,23,0,48
2004,306,Indiana,32,31,0,63
2004,17094,William Peace,19,14,1,34
2004,8981,Endicott,29,10,1,40
2004,713,Trinity (CT),12,16,0,28
2004,307,Indiana (PA),25,16,0,41
2004,1072,Erskine,18,28,0,46
2004,305,Indiana St.,23,41,0,64
2004,715,Trinity (TX),21,16,0,37
2004,218,Eureka,16,20,0,36
2004,1203,Mary Hardin-Baylor,25,13,0,38
2004,219,Evansville,40,20,0,60
2004,309,Indianapolis,14,26,0,40
2004,716,Troy,35,30,0,65
2004,455,Muskingum,43,7,0,50
2004,310,Iona,26,20,1,47
2004,576,Rider,35,22,0,57
2004,148,Cleveland St.,26,27,0,53
2004,312,Iowa,39,24,0,63
2004,722,Coast Guard,28,12,0,40
2004,45,Babson,26,18,0,44
2004,311,Iowa St.,13,31,0,44
2004,577,Ripon,26,10,0,36
2004,390,Mary Washington,16,17,0,33
2004,18422,Rivier,5,19,0,24
2004,149,Coastal Caro.,27,29,0,56
2004,488,N.C. A&T,19,40,0,59
2004,578,Roanoke,34,12,0,46
2004,499,Truman,44,12,0,56
2004,220,Fairfield,29,33,0,62
2004,94,Bakersfield,44,20,0,64
2004,489,N.C. Central,17,20,0,37
2004,46,Baldwin Wallace,21,15,0,36
2004,579,Robert Morris,12,33,1,46
2004,308,IPFW,10,31,1,42
2004,222,Fairleigh Dickinson,15,29,0,44
2004,491,N.C. Wesleyan,12,26,0,38
2004,313,Ithaca,28,15,0,43
2004,789,Williams,32,10,0,42
2004,47,Ball St.,15,39,0,54
2004,665,Southern U.,27,18,0,45
2004,2699,IUPUI,22,26,0,48
2004,1460,Wilmington (DE),14,22,0,36
2004,392,Maryland,33,27,0,60
2004,8577,N.M. Highlands,24,23,0,47
2004,717,Tufts,16,16,0,32
2004,314,Jackson St.,9,28,0,37
2004,1461,Wilmington (OH),13,22,0,35
2004,12973,Wilson,8,16,0,24
2004,667,Southern Utah,38,18,0,56
2004,1076,Fairmont St.,17,22,0,39
2004,316,Jacksonville,22,42,0,64
2004,958,Baptist Bible (PA),14,13,0,27
2004,1462,Wingate,31,16,0,47
2004,790,Winona St.,37,15,0,52
2004,27892,Farmingdale St.,11,16,0,27
2004,315,Jacksonville St.,41,21,0,62
2004,395,Maryville (MO),24,17,0,41
2004,791,Winston-Salem,22,11,0,33
2004,317,James Madison,30,32,0,62
2004,396,Maryville (TN),21,14,0,35
2004,792,Winthrop,42,24,1,67
2004,223,Fayetteville St.,16,23,0,39
2004,8911,Wis. Lutheran,7,20,0,27
2004,397,Marywood,6,20,0,26
2004,221,FDU-Florham,13,19,0,32
2004,793,Wis.-Eau Claire,26,17,0,43
2004,150,Coe,25,14,0,39
2004,399,Mass. Maritime,2,20,2,24
2004,795,Wis.-La Crosse,19,25,0,44
2004,1379,Southern Vt.,4,22,0,26
2004,798,Wis.-Oshkosh,20,19,0,39
2004,799,Wis.-Parkside,32,20,0,52
2004,49,Barry,31,18,0,49
2004,581,Rochester (NY),17,20,0,37
2004,1023,Coker,25,25,0,50
2004,800,Wis.-Platteville,13,23,0,36
2004,23157,Felician,11,14,14,39
2004,719,Tulsa,45,18,0,63
2004,400,Massachusetts,34,17,0,51
2004,462,Neb. Wesleyan,28,12,0,40
2004,773,McDaniel,27,11,0,38
2004,1156,Neb.-Kearney,18,21,0,39
2004,580,Rochester Inst.,24,16,0,40
2004,801,Wis.-River Falls,20,22,0,42
2004,224,Ferris St.,24,21,1,46
2004,12830,Tusculum,29,18,0,47
2004,320,John Carroll,21,15,0,36
2004,463,Nebraska,45,17,0,62
2004,321,John Jay,14,15,0,29
2004,1254,Neumann,12,18,0,30
2004,225,Ferrum,28,15,1,44
2004,15646,Barton,12,32,0,44
2004,720,Tuskegee,22,21,0,43
2004,582,Rockford,12,27,0,39
2004,466,Nevada,38,28,0,66
2004,1014,Col. of Charleston,43,23,0,66
2004,802,Wis.-Stevens Point,20,21,0,41
2004,58,Baruch,11,11,0,22
2004,1255,U New England,8,15,0,23
2004,22626,Johnson & Wales (RI),13,27,0,40
2004,467,New England Col.,11,25,0,36
2004,486,MCLA,12,20,0,32
2004,50,Bates,8,19,0,27
2004,9,UAB,20,36,0,56
2004,26520,Bay Path,7,20,1,28
2004,803,Wis.-Stout,27,16,0,43
2004,151,Colby,18,11,1,30
2004,323,Johnson C. Smith,12,21,0,33
2004,402,McNeese St.,19,41,0,60
2004,804,Wis.-Superior,32,8,0,40
2004,583,Roger Williams,21,15,0,36
2004,108,UC Davis,26,26,0,52
2004,51,Baylor,48,17,0,65
2004,324,Johnson St.,17,16,0,33
2004,805,Wis.-Whitewater,32,14,0,46
2004,26107,Becker,17,10,0,27
2004,325,Juniata,17,13,0,30
2004,153,Colgate,34,17,0,51
2004,379,Me.-Farmington,14,14,0,28
2004,796,Wisconsin,29,28,0,57
2004,111,UC Riverside,13,50,0,63
2004,326,Kalamazoo,5,26,0,31
2004,584,Rollins,42,16,0,58
2004,52,Bellarmine,15,27,1,43
2004,1079,Findlay,13,33,0,46
2004,806,Wittenberg,20,15,0,35
2004,112,UC San Diego,29,27,0,56
2004,470,New Haven,10,10,0,20
2004,787,Wm. Paterson,26,8,0,34
2004,104,UC Santa Barbara,32,31,0,63
2004,154,Colorado Col.,5,20,0,25
2004,319,New Jersey City,11,24,0,35
2004,585,Rose-Hulman,21,18,0,39
2004,328,Kansas,33,28,1,62
2004,226,Fisk,1,29,7,37
2004,11416,Colorado Mesa,30,22,0,52
2004,473,New Mexico,30,35,0,65
2004,15882,Rosemont,10,17,0,27
2004,807,Wooster,16,19,0,35
2004,14927,Belmont,15,36,0,51
2004,227,Fitchburg St.,19,15,0,34
2004,809,Worcester St.,16,16,0,32
2004,23725,Medaille,9,22,0,31
2004,9754,UC-Colo. Springs,39,13,0,52
2004,155,Colorado Mines,22,23,0,45
2004,259,Rowan,28,10,0,38
2004,472,New Mexico St.,14,49,0,63
2004,808,WPI,11,20,0,31
2004,329,Kean,14,22,0,36
2004,231,FIU,30,34,0,64
2004,2683,Belmont Abbey,31,26,0,57
2004,2755,Southwest Baptist,8,31,0,39
2004,156,Colorado St.,40,14,0,54
2004,810,Wright St.,16,43,1,60
2004,330,Keene St.,29,12,0,41
2004,476,New Rochelle,0,4,17,21
2004,229,Fla. Atlantic,56,18,0,74
2004,53,Beloit,16,12,0,28
2004,8736,Southwest Minn. St.,22,31,0,53
2004,2720,Colorado St.-Pueblo,13,30,0,43
2004,506221,Fla. Gulf Coast,1,2,0,3
2004,1157,Kennesaw St.,64,6,0,70
2004,1257,Newberry,26,27,0,53
2004,54,Bemidji St.,2,29,0,31
2004,128,UCF,42,21,0,63
2004,158,Columbia,25,26,0,51
2004,21772,Newbury,0,17,2,19
2004,331,Kent St.,27,20,0,47
2004,403,Medgar Evers,7,16,0,23
2004,55,Benedict,28,11,2,41
2004,813,Yale,30,22,0,52
2004,233,Fla. Southern,55,8,0,63
2004,110,UCLA,47,9,0,56
2004,334,Kentucky,25,31,1,57
2004,482,Niagara,20,26,0,46
2004,332,Kentucky St.,27,8,0,35
2004,164,UConn,23,23,0,46
2004,159,Columbus St.,32,17,0,49
2004,335,Kenyon,17,15,0,32
2004,483,Nicholls St.,24,29,0,53
2004,401,UMass Boston,6,24,0,30
2004,235,Florida,41,20,0,61
2004,1159,Keuka,2,13,8,23
2004,484,Nichols,2,21,0,23
2004,656,UMass Dartmouth,2,16,0,18
2004,405,Menlo,14,22,0,36
2004,2730,York (NY),4,12,0,16
2004,228,Florida A&M,34,31,0,65
2004,815,York (PA),19,22,0,41
2004,368,UMass Lowell,26,25,0,51
2004,8744,Southwestern Okla.,31,17,0,48
2004,296,Benedictine (IL),23,17,1,41
2004,1028,Concord,13,25,0,38
2004,485,Norfolk St.,9,36,1,46
2004,234,Florida St.,62,12,0,74
2004,487,North Ala.,19,33,0,52
2004,391,UMBC,27,34,0,61
2004,56,Bentley,1,0,0,1
2004,230,Florida Tech,29,18,1,48
2004,406,Mercer,34,30,0,64
2004,457,North Carolina,44,22,0,66
2004,393,UMES,5,40,0,45
2004,724,Merchant Marine,28,16,1,45
2004,2707,UMKC,9,41,0,50
2004,407,Mercy,0,5,0,5
2004,11538,Fontbonne,27,13,0,40
2004,490,North Carolina St.,32,27,0,59
2004,408,Mercyhurst,15,23,1,39
2004,817,Youngstown St.,29,22,0,51
2004,492,North Central (IL),28,15,0,43
2004,409,Meredith,17,20,1,38
2004,59,Bethany (WV),29,15,0,44
2004,236,Fordham,35,24,1,60
2004,459,UNC Greensboro,30,30,0,60
2004,673,Springfield,20,15,4,39
2004,9011,Fort Hays St.,21,21,0,42
2004,537,UNC Pembroke,17,30,0,47
2004,1083,Fort Lewis,11,26,0,37
2004,237,Fort Valley St.,21,16,1,38
2004,411,Messiah,17,14,1,32
2004,460,UNCW,19,38,0,57
2004,592,St. Andrews,28,22,0,50
2004,494,North Dakota,16,33,0,49
2004,238,Framingham St.,15,21,0,36
2004,60,Bethel (MN),16,24,0,40
2004,593,St. Anselm,16,25,0,41
2004,412,Methodist,30,14,0,44
2004,504,UNI,17,32,0,49
2004,493,North Dakota St.,40,11,0,51
2004,1085,Francis Marion,37,17,0,54
2004,2711,North Florida,46,13,0,59
2004,727,Union (NY),25,5,1,31
2004,239,Frank. & Marsh.,16,17,0,33
2004,2694,Franklin,16,12,0,28
2004,241,Franklin Pierce,10,26,3,39
2004,242,Fredonia,26,15,0,41
2004,465,UNLV,25,35,0,60
2004,414,Miami (OH),25,26,1,52
2004,728,Upper Iowa,28,18,0,46
2004,596,St. Bonaventure,12,24,0,36
2004,597,St. Catherine,9,26,0,35
2004,162,Concordia (NY),1,12,0,13
2004,730,Ursinus,33,11,1,45
2004,24400,Concordia (TX),5,31,0,36
2004,160,Concordia Chicago,4,26,0,30
2004,9223,North Greenville,13,22,0,35
2004,598,St. Cloud St.,42,15,0,57
2004,1036,Concordia Wisconsin,16,21,0,37
2004,10411,USC Upstate,38,16,0,54
2004,161,Concordia-M'head,12,22,0,34
2004,28594,USciences,11,21,0,32
2004,1334,St. Edward's,25,26,0,51
2004,96,Fresno St.,48,20,0,68
2004,9081,Concordia-St. Paul,42,20,0,62
2004,61,Bethune-Cookman,44,28,0,72
2004,501826,Friends,0,2,0,2
2004,695,UT Martin,40,21,0,61
2004,243,Frostburg St.,26,14,0,40
2004,418,Michigan,54,13,0,67
2004,9684,St. Elizabeth,3,17,8,28
2004,496,North Park,11,27,0,38
2004,62,Binghamton,17,23,2,42
2004,732,Utah,23,33,0,56
2004,244,Furman,15,48,0,63
2004,416,Michigan St.,36,26,0,62
2004,253,Ga. Southern,30,29,0,59
2004,1097,Ga. Southwestern,1,0,0,1
2004,28593,Birmingham-So.,25,34,0,59
2004,245,Gallaudet,10,20,0,30
2004,731,Utah St.,10,41,0,51
2004,246,Gannon,28,17,0,45
2004,419,Middle Tenn.,35,23,0,58
2004,497,North Texas,22,57,0,79
2004,30024,Utah Valley,1,7,0,8
2004,1092,Gardner-Webb,30,32,1,63
2004,599,St. Francis Brooklyn,2,44,1,47
2004,704,UTEP,8,46,0,54
2004,165,Coppin St.,18,23,0,41
2004,601,St. John Fisher,28,17,0,45
2004,167,Cornell,42,13,0,55
2004,603,St. John's (NY),28,26,0,54
2004,8687,St. Joseph (CT),2,18,5,25
2004,604,St. Joseph's (IN),17,33,0,50
2004,12810,Northeastern St.,27,19,0,46
2004,1340,St. Joseph's (L.I.),11,19,0,30
2004,605,St. Joseph's (ME),7,22,0,29
2004,607,St. Lawrence,13,15,0,28
2004,502,Northern Colo.,6,32,0,38
2004,64,Blackburn,13,16,0,29
2004,503,Northern Ill.,14,41,0,55
2004,984,Bloomfield,3,38,0,41
2004,610,St. Mary's (CA),13,43,0,56
2004,65,Bloomsburg,28,16,1,45
2004,8688,St. Mary's (IN),20,19,0,39
2004,505,Northern Ky.,54,7,0,61
2004,985,Bluefield St.,5,30,17,52
2004,987,Bluffton,26,8,0,34
2004,1266,Northern St.,6,33,0,39
2004,1267,Northland,1,13,23,37
2004,507,Northwest Mo. St.,20,33,0,53
2004,1274,Northwest Nazarene,10,39,0,49
2004,509,Northwestern,34,20,0,54
2004,67,Boston College,33,25,0,58
2004,506013,Northwestern Okla.,1,3,0,4
2004,68,Boston U.,26,32,0,58
2004,69,Bowdoin,22,10,0,32
2004,70,Bowie St.,8,18,0,26
2004,71,Bowling Green,34,30,0,64
2004,508,Northwestern St.,35,28,0,63
2004,510,Northwood (MI),14,33,0,47
2004,72,Bradley,29,29,0,58
2004,511,Norwich,24,11,0,35
2004,73,Brandeis,13,21,0,34
2004,513,Notre Dame,49,20,0,69
2004,74,Bridgeport,7,9,0,16
2004,75,Bridgewater (VA),26,17,0,43
2004,76,Bridgewater St.,24,18,0,42
2004,24639,Nova Southeastern,32,26,1,59
2004,1277,Nyack,11,21,4,36
2004,78,Brockport,10,21,0,31
2004,79,Brooklyn,6,17,0,23
2004,80,Brown,19,20,0,39
