year,team_id,team_name,wins,losses,ties,total_games
2010,166,Cornell College,18,19,1,38
2010,420,Middlebury,18,12,0,30
2010,30084,Geneva,23,17,0,40
2010,733,Utica,13,27,0,40
2010,26172,A&M-Corpus Chris,35,22,0,57
2010,477,NYIT,33,23,0,56
2010,336,King's (PA),23,18,0,41
2010,587,Rutgers,24,31,0,55
2010,81,Bryant,8,37,0,45
2010,1346,St. Mary's (TX),34,20,0,54
2010,1094,George Fox,13,27,0,40
2010,706,UTSA,23,29,0,52
2010,2,Abilene Christian,21,31,0,52
2010,588,Rutgers-Camden,22,16,0,38
2010,169,Creighton,37,23,0,60
2010,248,George Mason,21,24,0,45
2010,30123,Academy of Art,29,23,1,53
2010,589,Rutgers-Newark,11,27,0,38
2010,337,Knox,7,25,0,32
2010,514,Oakland,17,37,0,54
2010,30035,Crown (MN),0,27,0,27
2010,745,Va. Wesleyan,34,9,0,43
2010,11276,S.C. Aiken,23,23,0,46
2010,929,Adams St.,16,22,0,38
2010,1278,Oakland City,21,26,0,47
2010,101,CSUN,31,22,0,53
2010,102,Sacramento St.,23,31,0,54
2010,515,Oberlin,4,32,0,36
2010,734,Valdosta St.,51,9,0,60
2010,249,George Washington,6,39,0,45
2010,590,Sacred Heart,23,26,0,49
2010,339,Kutztown,43,18,0,61
2010,516,Occidental,8,24,0,32
2010,333,Ky. Wesleyan,15,30,0,45
2010,614,St. Norbert,33,8,0,41
2010,1163,La Roche,17,21,0,38
2010,3,Adelphi,32,24,0,56
2010,615,St. Olaf,19,21,0,40
2010,340,La Salle,13,30,1,44
2010,4,Adrian,29,11,0,40
2010,11324,Agnes Scott,8,25,0,33
2010,519,Ohio,20,32,0,52
2010,616,St. Paul's,11,18,1,30
2010,83,Bucknell,28,20,1,49
2010,341,La Verne,27,20,0,47
2010,84,Buena Vista,15,19,0,34
2010,251,Georgetown,18,33,0,51
2010,618,St. Scholastica,29,13,0,42
2010,5,Akron,20,34,0,54
2010,11036,Sage Colleges,8,26,0,34
2010,671,La.-Lafayette,45,18,0,63
2010,506003,Georgetown (KY),0,2,0,2
2010,170,Curry,19,21,0,40
2010,86,Buffalo,21,34,0,55
2010,10,Ala.-Huntsville,41,12,0,53
2010,498,La.-Monroe,24,26,0,50
2010,591,Saginaw Valley,30,16,0,46
2010,85,Buffalo St.,20,20,0,40
2010,257,Georgia,50,13,0,63
2010,8,Alabama,52,11,0,63
2010,342,Lafayette,15,33,0,48
2010,1059,D'Youville,8,24,0,32
2010,735,Valparaiso,57,36,1,94
2010,6,Alabama A&M,8,25,0,33
2010,1222,Midwestern St.,54,10,0,64
2010,87,Butler,56,33,0,89
2010,620,St. Thomas (MN),40,8,0,48
2010,7,Alabama St.,16,27,0,43
2010,517,Ohio Northern,41,7,0,48
2010,1162,LaGrange,25,21,0,46
2010,594,Saint Augustine's,1,25,0,26
2010,1348,St. Thomas Aquinas,7,38,0,45
2010,77,BYU,46,13,0,59
2010,518,Ohio St.,39,14,0,53
2010,1096,Georgia College,13,32,0,45
2010,2685,BYU-Hawaii,4,34,0,38
2010,674,Stanford,37,19,0,56
2010,595,Saint Benedict,14,22,0,36
2010,675,Staten Island,24,17,0,41
2010,506033,Dakota Wesleyan,0,2,0,2
2010,15207,Ohio Valley,13,32,0,45
2010,88,Cabrini,25,19,0,44
2010,422,Miles,21,27,0,48
2010,14,Albany (NY),20,23,0,43
2010,676,Stephen F. Austin,29,20,0,49
2010,1305,Cairn,11,25,0,36
2010,600,Saint Francis (PA),14,36,0,50
2010,13,Albany St. (GA),36,25,0,61
2010,1044,Dallas,18,18,0,36
2010,105,Cal Lutheran,16,24,0,40
2010,2798,Albertus Magnus,0,28,0,28
2010,90,Cal Poly,23,24,0,47
2010,2746,Lake Erie,8,34,0,42
2010,15,Albion,11,23,0,34
2010,423,Millersville,23,24,0,47
2010,16,Albright,7,27,0,34
2010,678,Stetson,34,21,0,55
2010,17,Alcorn,24,28,0,52
2010,92,Cal St. Dom. Hills,33,21,0,54
2010,344,Lake Forest,24,14,1,39
2010,934,Alderson Broaddus,21,26,0,47
2010,2691,Daniel Webster,13,17,0,30
2010,254,Georgia St.,37,19,0,56
2010,18,Alfred,37,8,0,45
2010,98,Cal St. East Bay,14,36,0,50
2010,679,Stevens,8,28,0,36
2010,520,Ohio Wesleyan,24,15,0,39
2010,172,Dartmouth,14,27,0,41
2010,424,Millikin,24,16,0,40
2010,21852,Stevenson,23,16,0,39
2010,680,Stillman,12,25,0,37
2010,345,Lake Superior St.,10,38,0,48
2010,681,Stockton,28,17,0,45
2010,255,Georgia Tech,51,11,0,62
2010,606,Saint Joseph's,29,18,0,47
2010,97,Cal St. Fullerton,14,39,0,53
2010,174,Davis & Elkins,16,36,1,53
2010,682,Stonehill,20,19,1,40
2010,426,Millsaps,24,18,0,42
2010,683,Stony Brook,32,21,1,54
2010,608,Saint Leo,22,31,0,53
2010,739,Villanova,27,28,0,55
2010,175,Dayton,18,36,1,55
2010,9004,Georgian Court,39,19,0,58
2010,1164,Lakeland,27,18,0,45
2010,24342,Okla. Panhandle,3,44,0,47
2010,684,Suffolk,9,31,0,40
2010,609,Saint Louis,30,26,1,57
2010,258,Gettysburg,21,16,1,38
2010,427,Minn. Duluth,32,17,0,49
2010,522,Oklahoma,47,12,0,59
2010,746,Virginia,34,23,0,57
2010,1343,Saint Martin's,20,35,0,55
2010,503905,Oklahoma City,0,1,0,1
2010,1098,Glenville St.,29,30,0,59
2010,383,Minn. St. Mankato,36,15,0,51
2010,743,Virginia St.,17,20,0,37
2010,19,Allegheny,12,21,0,33
2010,1050,Defiance,18,18,0,36
2010,521,Oklahoma St.,44,16,0,60
2010,1390,Sul Ross St.,2,38,0,40
2010,8366,Goldey-Beacom,16,23,0,39
2010,1240,Minn. St. Moorhead,7,39,0,46
2010,742,Virginia Tech,25,33,0,58
2010,180,Delaware,20,30,1,51
2010,744,Virginia Union,2,23,1,26
2010,612,Saint Mary's (MN),16,24,0,40
2010,27854,Minn.-Crookston,9,33,0,42
2010,1099,Gordon,14,20,0,34
2010,178,Delaware St.,28,20,0,48
2010,168,SUNY Cortland,40,8,0,48
2010,30055,Cal St. Monterey Bay,33,20,0,53
2010,1226,Minn.-Morris,16,24,0,40
2010,179,Delaware Valley,15,16,0,31
2010,1167,Lander,23,24,0,47
2010,247,SUNY Geneseo,25,17,0,42
2010,93,Cal St. San B'dino,27,27,0,54
2010,613,Saint Michael's,9,31,0,40
2010,181,Delta St.,27,27,0,54
2010,428,Minnesota,16,37,0,53
2010,347,Lane,15,12,1,28
2010,103,Cal St. Stanislaus,13,36,1,50
2010,524,Old Westbury,20,19,0,39
2010,617,Saint Peter's,2,36,0,38
2010,182,Denison,30,17,0,47
2010,995,Caldwell,42,16,0,58
2010,1347,Saint Rose,11,29,0,40
2010,107,California,44,19,0,63
2010,30064,Saint Vincent,18,15,0,33
2010,176,DePaul,39,18,0,57
2010,106,California (PA),37,14,0,51
2010,433,Ole Miss,29,27,0,56
2010,16142,Misericordia,28,18,0,46
2010,177,DePauw,40,9,0,49
2010,21,Alma,30,11,0,41
2010,20,DeSales,29,20,0,49
2010,19117,Salem Int'l,2,30,0,32
2010,938,Alvernia,22,15,0,37
2010,8486,Lasell,19,20,1,40
2010,261,Grambling,12,27,0,39
2010,28746,Alverno,13,27,0,40
2010,184,Detroit,8,60,0,68
2010,621,Salem St.,35,10,1,46
2010,525,Olivet,14,18,0,32
2010,1104,Grand Canyon,42,13,0,55
2010,185,Dickinson,19,19,0,38
2010,262,Grand Valley St.,22,24,0,46
2010,622,Salisbury,36,4,0,40
2010,348,Lawrence,16,16,0,32
2010,429,Mississippi Col.,29,13,0,42
2010,623,Salve Regina,20,14,0,34
2010,475,SUNY New Paltz,20,18,0,38
2010,794,Green Bay,34,28,0,62
2010,526,SUNY Oneonta,21,17,0,38
2010,22,American Int'l,28,26,0,54
2010,748,Wagner,13,32,0,45
2010,464,Omaha,84,19,0,103
2010,624,Sam Houston St.,21,28,0,49
2010,9500,SUNY Poly,29,9,0,38
2010,349,Le Moyne,23,20,0,43
2010,114,Calvin,11,24,0,35
2010,24,Amherst,18,16,0,34
2010,552,SUNY Potsdam,8,24,0,32
2010,430,Mississippi St.,26,29,0,55
2010,939,Anderson (IN),18,22,0,40
2010,625,Samford,19,31,0,50
2010,685,Susquehanna,34,13,0,47
2010,11062,Green Mountain,3,25,0,28
2010,627,San Diego,22,25,0,47
2010,13028,Anderson (SC),27,18,0,45
2010,686,Swarthmore,21,23,0,44
2010,529,Oregon,36,21,0,57
2010,687,Sweet Briar,5,30,0,35
2010,750,Wartburg,14,20,0,34
2010,263,Greensboro,28,15,1,44
2010,996,Cameron,22,26,0,48
2010,688,Syracuse,32,26,0,58
2010,751,Wash. & Jeff.,12,26,0,38
2010,528,Oregon St.,24,31,0,55
2010,1111,Greenville,18,18,0,36
2010,115,Campbell,23,31,1,55
2010,432,Mississippi Val.,27,23,0,50
2010,351,Lebanon Valley,34,13,0,47
2010,25,Angelo St.,50,15,0,65
2010,264,Grinnell,6,28,0,34
2010,116,Canisius,34,19,0,53
2010,530,Oswego St.,5,29,0,34
2010,26,Anna Maria,22,22,0,44
2010,265,Grove City,14,23,0,37
2010,27,Appalachian St.,27,25,0,52
2010,39,GRU Augusta,40,17,0,57
2010,531,Otterbein,7,27,0,34
2010,2814,Washburn,36,48,0,84
2010,626,San Diego St.,34,16,0,50
2010,30095,Dixie St.,39,14,0,53
2010,1112,Guilford,28,13,1,42
2010,1289,Ouachita Baptist,36,24,0,60
2010,434,Missouri,51,13,0,64
2010,756,Washington,50,9,0,59
2010,628,San Fran. St.,20,33,0,53
2010,23008,Ozarks (AR),9,31,0,40
2010,266,Gust. Adolphus,30,13,0,43
2010,12399,Gwynedd Mercy,8,25,0,33
2010,753,Washington Col.,13,19,0,32
2010,435,Missouri S&T,27,23,0,50
2010,267,Hamilton,5,23,0,28
2010,966,Arcadia,14,25,0,39
2010,268,Hamline,19,19,0,38
2010,30118,Dominican (CA),2,32,0,34
2010,29,Arizona,52,14,0,66
2010,117,Capital,24,15,0,39
2010,669,Missouri St.,21,32,0,53
2010,755,Washington-St. Louis,37,11,0,48
2010,689,Tampa,23,17,0,40
2010,1332,Dominican (IL),24,15,0,39
2010,28,Arizona St.,44,17,0,61
2010,13302,Lees-McRae,12,32,0,44
2010,270,Hampton,21,38,0,59
2010,8956,Dominican (NY),37,16,0,53
2010,1115,Hanover,9,27,0,36
2010,398,MIT,7,18,0,25
2010,1395,Tarleton St.,23,27,0,50
2010,271,Hardin-Simmons,24,13,0,37
2010,2692,Dowling,44,17,0,61
2010,30042,Mitchell,22,14,0,36
2010,352,Lehigh,31,19,0,50
2010,189,Drake,32,22,0,54
2010,272,Hartford,16,24,0,40
2010,279,Lehman,8,23,0,31
2010,190,Drew,12,25,0,37
2010,8411,Ark.-Monticello,55,13,0,68
2010,191,Drexel,20,24,0,44
2010,757,Wayne St. (MI),52,13,0,65
2010,350,LeMoyne-Owen,9,18,0,27
2010,2678,Ark.-Pine Bluff,6,29,0,35
2010,9012,Mo. Southern St.,41,56,1,98
2010,1057,Drury,22,30,0,52
2010,712,TCNJ,33,10,0,43
2010,275,Harvard,27,23,0,50
2010,192,Dubuque,10,25,0,35
2010,31,Arkansas,28,29,0,57
2010,1170,Lenoir-Rhyne,53,9,0,62
2010,9013,Mo. Western St.,57,36,0,93
2010,690,Temple,19,30,0,49
2010,1433,Wayne St. (NE),43,14,0,57
2010,24317,Lesley,26,13,0,39
2010,118,Carleton,6,30,0,36
2010,436,Mo.-St. Louis,26,20,0,46
2010,1434,Waynesburg,13,19,0,32
2010,533,Pace,23,27,0,50
2010,694,Tennessee,49,15,0,64
2010,8490,LeTourneau,15,21,0,36
2010,947,Arkansas Tech,22,26,0,48
2010,691,Tennessee St.,11,34,0,45
2010,534,Pacific,24,30,0,54
2010,692,Tennessee Tech,28,30,0,58
2010,354,Lewis,39,17,0,56
2010,437,Molloy,43,21,0,64
2010,30090,Tex. A&M Int'l,22,27,0,49
2010,758,Weber St.,2,48,0,50
2010,630,San Jose St.,34,25,0,59
2010,2751,Pacific (OR),23,17,0,40
2010,22235,Lewis & Clark,3,36,0,39
2010,759,Webster,24,13,0,37
2010,120,Carroll (WI),12,19,0,31
2010,1297,Pacific Lutheran,23,15,0,38
2010,631,Santa Clara,10,35,0,45
2010,760,Wellesley,28,10,0,38
2010,276,Haverford,17,17,0,34
2010,439,Monmouth,30,18,0,48
2010,1000,Carson-Newman,37,12,0,49
2010,761,Wells,12,14,0,26
2010,535,Paine,1,27,0,28
2010,196,East Carolina,44,18,0,62
2010,33,Armstrong,33,20,0,53
2010,762,Wentworth,13,23,1,37
2010,8965,East Central,34,21,0,55
2010,277,Hawaii,50,16,0,66
2010,355,Liberty,39,18,0,57
2010,438,Monmouth (IL),14,22,0,36
2010,121,Carthage,25,15,0,40
2010,632,Savannah St.,18,23,0,41
2010,763,Wesley,6,30,0,36
2010,197,East Stroudsburg,19,30,0,49
2010,696,Tex. A&M-Kingsville,22,23,0,45
2010,2697,Hawaii Hilo,35,16,0,51
2010,764,Wesleyan (CT),24,18,1,43
2010,205,Mont. St. Billings,22,29,0,51
2010,198,East Tenn. St.,21,35,0,56
2010,1174,Limestone,40,22,0,62
2010,14718,Wesleyan (GA),2,28,0,30
2010,30088,Tex. Permian Basin,18,29,0,47
2010,2696,Hawaii Pacific,50,8,0,58
2010,1355,Schreiner,17,20,0,37
2010,725,Army,33,20,0,53
2010,122,Case,9,33,0,42
2010,633,Scranton,15,17,0,32
2010,30045,Palm Beach Atl.,36,13,0,49
2010,358,West Ala.,38,23,0,61
2010,703,Texas,43,15,0,58
2010,765,West Chester,32,18,0,50
2010,1356,Seattle,16,32,1,49
2010,11740,West Florida,40,16,0,56
2010,1062,East Tex. Baptist,40,12,0,52
2010,697,Texas A&M,44,16,0,60
2010,356,Lincoln (MO),22,53,0,75
2010,766,West Ga.,16,41,0,57
2010,123,Castleton,16,20,0,36
2010,203,East. Mennonite,19,18,0,37
2010,357,Lincoln (PA),7,19,0,26
2010,278,Heidelberg,22,16,0,38
2010,8968,Eastern,12,22,0,34
2010,1001,Catawba,29,24,0,53
2010,200,Eastern Conn. St.,39,6,1,46
2010,1123,Henderson St.,28,26,0,54
2010,635,Seton Hall,19,31,0,50
2010,1176,Lincoln Memorial,28,23,0,51
2010,124,Catholic,26,15,0,41
2010,767,West Tex. A&M,45,18,0,63
2010,1124,Hendrix,19,19,0,38
2010,201,Eastern Ill.,24,27,0,51
2010,505260,Texas Col.,0,6,0,6
2010,23624,Cazenovia,13,14,0,27
2010,202,Eastern Ky.,15,34,0,49
2010,9630,West Va. Wesleyan,44,13,0,57
2010,8398,Hilbert,11,19,0,30
2010,540,Penn,19,23,0,42
2010,204,Eastern Mich.,19,30,1,50
2010,442,Montclair St.,21,15,0,36
2010,1400,Texas Lutheran,14,24,0,38
2010,14795,Cedar Crest,10,24,0,34
2010,1439,West Virginia St.,33,23,0,56
2010,206,Eastern N.M.,16,37,0,53
2010,769,Western Caro.,10,43,0,53
2010,699,Texas Southern,21,20,0,41
2010,770,Western Conn. St.,24,18,0,42
2010,30063,Seton Hill,24,26,1,51
2010,280,Hillsdale,16,28,0,44
2010,771,Western Ill.,35,19,0,54
2010,652,Sewanee,2,17,0,19
2010,772,Western Ky.,27,25,0,52
2010,636,Shaw,15,25,0,40
2010,35,Ashland,36,13,0,49
2010,670,Texas St.,27,26,0,53
2010,281,Hiram,20,17,0,37
2010,1064,Eastern Nazarene,4,28,0,32
2010,774,Western Mich.,13,25,1,39
2010,637,Shenandoah,21,19,1,41
2010,443,Moravian,34,15,0,49
2010,36,Assumption,26,20,0,46
2010,10870,Shepherd,36,16,0,52
2010,444,Morehead St.,27,24,0,51
2010,1445,Western N.M.,27,24,0,51
2010,638,Shippensburg,16,26,0,42
2010,125,Centenary (LA),10,34,0,44
2010,700,Texas Tech,38,18,0,56
2010,12884,Centenary (NJ),30,14,0,44
2010,1179,Linfield,42,7,0,49
2010,446,Morgan St.,7,26,0,33
2010,37,Auburn,31,26,0,57
2010,126,Central (IA),30,14,0,44
2010,38,Augsburg,21,19,0,40
2010,775,Western New Eng.,26,20,1,47
2010,40,Augustana (IL),31,15,0,46
2010,1004,Central Ark.,25,31,0,56
2010,28600,Lipscomb,50,13,0,63
2010,208,Eckerd,15,35,1,51
2010,127,Central Conn. St.,19,31,0,50
2010,1446,Western Ore.,32,21,0,53
2010,41,Augustana (SD),46,14,0,60
2010,701,Texas Woman's,39,22,0,61
2010,506026,Central Methodist,0,2,0,2
2010,361,LIU Brooklyn,39,18,0,57
2010,129,Central Mich.,27,19,0,46
2010,539,Penn St.,29,22,0,51
2010,42,Aurora,38,9,0,47
2010,1066,Edgewood,15,21,0,36
2010,30067,Morrisville St.,11,27,0,38
2010,362,LIU Post,41,16,0,57
2010,702,Texas-Arlington,29,25,0,54
2010,283,Hofstra,45,12,0,57
2010,953,Austin,12,18,0,30
2010,130,Central Mo.,48,46,0,94
2010,30036,Mount Aloysius,26,13,0,39
2010,30081,Penn St. Harrisburg,8,25,0,33
2010,359,Livingstone,11,15,0,26
2010,43,Austin Peay,16,35,0,51
2010,1009,Central Okla.,32,21,0,53
2010,23121,Texas-Dallas,16,24,0,40
2010,360,Lock Haven,22,21,0,43
2010,1448,Western Wash.,27,25,0,52
2010,209,Edinboro,19,18,0,37
2010,44,Averett,5,25,0,30
2010,27901,Mount Ida,17,19,0,36
2010,501555,Edward Waters,0,1,0,1
2010,30114,Penn St.-Abington,3,31,0,34
2010,285,Holy Cross,14,31,0,45
2010,99,Long Beach St.,26,26,0,52
2010,777,Westfield St.,26,13,0,39
2010,30028,Texas-Tyler,38,9,0,47
2010,363,Longwood,36,16,0,52
2010,707,Thiel,19,20,0,39
2010,364,Loras,16,21,0,37
2010,210,Elizabeth City St.,8,17,0,25
2010,25719,Penn St.-Altoona,21,18,1,40
2010,2758,Thomas (ME),18,18,0,36
2010,639,Siena,14,37,0,51
2010,211,Elizabethtown,18,13,1,32
2010,538,Penn St.-Behrend,17,21,0,38
2010,640,Simmons,23,12,0,35
2010,30127,Simon Fraser,1,3,0,4
2010,1182,Louisiana Col.,44,8,0,52
2010,212,Elmhurst,22,16,0,38
2010,641,Simpson,33,12,0,45
2010,1402,Thomas More,22,20,0,42
2010,366,Louisiana Tech,26,21,0,47
2010,30044,Penn St.-Berks,15,21,0,36
2010,213,Elmira,16,10,0,26
2010,1010,Central Wash.,40,15,0,55
2010,367,Louisville,41,19,0,60
2010,132,Centre,16,26,0,42
2010,532,Elms,20,17,0,37
2010,1012,Chadron St.,25,30,0,55
2010,1245,Mount Olive,23,29,0,52
2010,133,Chaminade,17,35,0,52
2010,1403,Tiffin,34,18,0,52
2010,1068,Elon,38,21,0,59
2010,1126,Holy Family,24,23,0,47
2010,660,SIUE,27,24,0,51
2010,371,Loyola Chicago,37,39,0,76
2010,452,Mount Union,25,15,0,40
2010,642,Skidmore,23,14,0,37
2010,214,Emerson,28,13,0,41
2010,45,Babson,24,15,0,39
2010,20220,MSOE,15,17,0,32
2010,709,Toledo,12,39,0,51
2010,643,Slippery Rock,22,21,0,43
2010,1450,Westminster (MO),7,24,0,31
2010,644,Smith,2,26,0,28
2010,370,Loyola Marymount,22,26,0,48
2010,8404,Hood,17,23,0,40
2010,1451,Westminster (PA),25,16,0,41
2010,286,Hope,20,18,0,38
2010,365,LSU,45,16,0,61
2010,542,Pfeiffer,21,29,0,50
2010,8567,Mt. St. Joseph,12,22,0,34
2010,94,Bakersfield,22,34,0,56
2010,711,Towson,33,23,0,56
2010,1468,Mt. St. Mary (NY),17,24,0,41
2010,46,Baldwin Wallace,23,17,0,40
2010,645,Sonoma St.,43,18,0,61
2010,215,Emmanuel (MA),10,21,0,31
2010,543,Philadelphia U.,26,20,0,46
2010,28749,Transylvania,35,11,0,46
2010,134,Chapman,16,20,0,36
2010,450,Mt. St. Mary's,25,25,0,50
2010,646,South Ala.,21,24,0,45
2010,288,Houston,30,24,1,55
2010,47,Ball St.,43,16,0,59
2010,217,Emory,25,16,0,41
2010,287,Houston Baptist,16,30,0,46
2010,958,Baptist Bible (PA),16,21,0,37
2010,648,South Carolina,11,40,0,51
2010,778,Wheaton (IL),21,19,0,40
2010,290,Howard,26,22,0,48
2010,21830,Piedmont,29,12,0,41
2010,216,Emory & Henry,3,21,0,24
2010,1013,Charleston (WV),34,22,0,56
2010,779,Wheaton (MA),20,18,0,38
2010,30037,Trine,28,15,0,43
2010,48,Charleston So.,30,28,1,59
2010,372,Luther,42,7,0,49
2010,2741,Howard Payne,10,25,0,35
2010,12799,Wheeling Jesuit,13,32,0,45
2010,713,Trinity (CT),20,14,0,34
2010,1071,Emporia St.,81,22,0,103
2010,451,Mt. St. Vincent,11,21,0,32
2010,373,Lycoming,14,24,0,38
2010,544,Pine Manor,6,25,0,31
2010,8896,Wheelock,1,25,0,26
2010,647,South Carolina St.,9,43,0,52
2010,458,Charlotte,40,18,0,58
2010,291,Humboldt St.,32,23,0,55
2010,374,Lynchburg,24,17,0,41
2010,8981,Endicott,28,12,1,41
2010,1315,Pitt.-Bradford,19,20,0,39
2010,30065,Lyndon St.,3,21,0,24
2010,650,South Dakota,21,30,1,52
2010,715,Trinity (TX),16,22,0,38
2010,10972,Chatham,7,25,0,32
2010,11839,Pitt.-Greensburg,5,23,0,28
2010,20794,Lynn,24,31,0,55
2010,453,Muhlenberg,14,19,0,33
2010,49,Barry,32,24,0,56
2010,781,Whittier,20,21,0,41
2010,376,Macalester,8,32,0,40
2010,15646,Barton,15,28,0,43
2010,1454,Whitworth,18,18,0,36
2010,292,Hunter,17,17,0,34
2010,454,Murray St.,22,29,0,51
2010,377,MacMurray,8,27,0,35
2010,1072,Erskine,23,23,1,47
2010,716,Troy,27,29,0,56
2010,380,Maine,23,28,0,51
2010,693,Chattanooga,39,17,0,56
2010,782,Wichita St.,22,31,0,53
2010,1130,Huntingdon,22,22,0,44
2010,455,Muskingum,22,21,0,43
2010,1314,Pittsburg St.,29,56,1,86
2010,218,Eureka,13,21,0,34
2010,783,Widener,27,15,0,42
2010,499,Truman,42,51,0,93
2010,378,Maine Maritime,20,7,0,27
2010,58,Baruch,23,22,0,45
2010,21323,Chestnut Hill,2,36,0,38
2010,717,Tufts,22,13,0,35
2010,219,Evansville,18,34,0,52
2010,1133,Husson,28,15,0,43
2010,545,Pittsburgh,27,25,0,52
2010,50,Bates,7,25,0,32
2010,547,Plattsburgh St.,25,16,0,41
2010,220,Fairfield,24,22,0,46
2010,1192,Manchester,23,20,1,44
2010,26520,Bay Path,21,20,0,41
2010,548,Plymouth St.,13,22,0,35
2010,488,N.C. A&T,28,27,0,55
2010,222,Fairleigh Dickinson,16,32,0,48
2010,381,Manhattan,25,23,1,49
2010,489,N.C. Central,7,37,0,44
2010,491,N.C. Wesleyan,12,22,0,34
2010,649,South Dakota St.,19,32,0,51
2010,8577,N.M. Highlands,17,29,0,46
2010,719,Tulsa,31,21,0,52
2010,651,South Fla.,24,29,0,53
2010,51,Baylor,28,25,0,53
2010,137,Chicago,25,15,1,41
2010,382,Manhattanville,18,19,1,38
2010,1076,Fairmont St.,33,20,0,53
2010,26107,Becker,10,26,0,36
2010,654,Southeast Mo. St.,17,31,0,48
2010,294,Idaho St.,14,39,0,53
2010,461,Nazareth,17,21,0,38
2010,384,Mansfield,12,16,0,28
2010,481,Polytechnic (NY),32,11,0,43
2010,655,Southeastern La.,11,37,0,48
2010,12830,Tusculum,17,27,0,44
2010,27892,Farmingdale St.,34,11,0,45
2010,462,Neb. Wesleyan,27,14,0,41
2010,549,Pomona-Pitzer,12,21,0,33
2010,52,Bellarmine,22,32,0,54
2010,1371,Southeastern Okla.,26,26,0,52
2010,95,Chico St.,33,21,0,54
2010,1194,Maranatha Baptist,3,30,0,33
2010,1156,Neb.-Kearney,15,30,0,45
2010,784,Wilkes,12,22,0,34
2010,223,Fayetteville St.,18,18,0,36
2010,14927,Belmont,10,44,0,54
2010,8875,Chowan,29,24,0,53
2010,463,Nebraska,30,29,0,59
2010,785,Willamette,28,12,0,40
2010,221,FDU-Florham,13,23,0,36
2010,1254,Neumann,27,18,0,45
2010,2683,Belmont Abbey,20,26,0,46
2010,300,Ill. Wesleyan,33,16,0,49
2010,1196,Marian (WI),21,21,0,42
2010,466,Nevada,17,28,0,45
2010,23157,Felician,15,28,0,43
2010,53,Beloit,9,26,0,35
2010,467,New England Col.,13,24,0,37
2010,720,Tuskegee,19,14,0,33
2010,302,Ill.-Chicago,37,52,0,89
2010,385,Marietta,21,14,0,35
2010,224,Ferris St.,26,16,0,42
2010,30050,Ill.-Springfield,13,31,0,44
2010,139,Chris. Newport,42,10,0,52
2010,54,Bemidji St.,5,36,0,41
2010,1376,Southern Ark.,10,33,0,43
2010,386,Marist,10,35,0,45
2010,470,New Haven,41,6,0,47
2010,55,Benedict,29,9,0,38
2010,550,Portland St.,30,27,0,57
2010,225,Ferrum,31,16,0,47
2010,1015,Christian Bros.,17,30,0,47
2010,319,New Jersey City,14,26,0,40
2010,1255,U New England,25,14,0,39
2010,1318,Post,16,30,0,46
2010,301,Illinois,45,8,0,53
2010,296,Benedictine (IL),36,7,0,43
2010,473,New Mexico,11,37,0,48
2010,553,Prairie View,2,38,0,40
2010,297,Illinois Col.,10,25,0,35
2010,17094,William Peace,20,22,0,42
2010,299,Illinois St.,32,20,0,52
2010,472,New Mexico St.,27,28,0,55
2010,9,UAB,37,22,0,59
2010,303,Immaculata,17,17,0,34
2010,658,Southern Conn. St.,42,13,0,55
2010,28755,FGCU,24,28,0,52
2010,1320,Presbyterian,21,28,0,49
2010,2743,Incarnate Word,28,24,0,52
2010,1199,Mars Hill,29,18,0,47
2010,30034,Presentation,3,23,0,26
2010,8580,City Tech,2,25,0,27
2010,554,Princeton,12,32,0,44
2010,306,Indiana,12,36,0,48
2010,555,Principia,1,21,0,22
2010,307,Indiana (PA),38,12,0,50
2010,388,Marshall,24,30,1,55
2010,1079,Findlay,14,36,0,50
2010,789,Williams,17,21,1,39
2010,56,Bentley,14,24,0,38
2010,305,Indiana St.,20,31,0,51
2010,8597,Martin Luther,15,23,0,38
2010,30032,Finlandia,6,28,0,34
2010,1460,Wilmington (DE),20,24,1,45
2010,1461,Wilmington (OH),12,20,0,32
2010,30075,Mary,31,23,0,54
2010,12973,Wilson,19,12,0,31
2010,556,Providence,22,28,0,50
2010,30058,Claflin,21,26,0,47
2010,108,UC Davis,26,29,0,55
2010,389,Mary Baldwin,2,37,0,39
2010,227,Fitchburg St.,10,24,0,34
2010,1462,Wingate,35,15,0,50
2010,659,Southern Ill.,38,20,0,58
2010,1203,Mary Hardin-Baylor,26,17,0,43
2010,476,New Rochelle,1,24,0,25
2010,309,Indianapolis,36,17,0,53
2010,557,Puget Sound,13,27,0,40
2010,390,Mary Washington,9,26,1,36
2010,310,Iona,28,26,0,54
2010,790,Winona St.,38,14,0,52
2010,111,UC Riverside,22,32,0,54
2010,142,Claremont-M-S,34,10,0,44
2010,30029,Purchase,9,22,0,31
2010,312,Iowa,25,23,0,48
2010,231,FIU,38,21,0,59
2010,392,Maryland,34,24,0,58
2010,1257,Newberry,30,13,0,43
2010,661,Southern Ind.,19,26,0,45
2010,311,Iowa St.,26,29,0,55
2010,112,UC San Diego,30,20,0,50
2010,143,Clarion,6,29,0,35
2010,559,Purdue,27,27,0,54
2010,104,UC Santa Barbara,15,37,0,52
2010,145,Clark (MA),23,13,0,36
2010,662,Southern Me.,13,30,0,43
2010,791,Winston-Salem,9,27,0,36
2010,229,Fla. Atlantic,28,26,0,54
2010,395,Maryville (MO),17,30,0,47
2010,21772,Newbury,12,23,0,35
2010,396,Maryville (TN),18,24,0,42
2010,664,Southern Miss.,25,28,0,53
2010,397,Marywood,19,18,0,37
2010,792,Winthrop,28,29,0,57
2010,59,Bethany (WV),35,15,0,50
2010,144,Clark Atlanta,22,24,0,46
2010,30054,Newman,5,33,0,38
2010,399,Mass. Maritime,2,24,0,26
2010,11504,Queens (NC),26,25,0,51
2010,468,Southern N.H.,18,22,0,40
2010,8911,Wis. Lutheran,11,25,0,36
2010,400,Massachusetts,42,10,1,53
2010,560,Queens (NY),16,31,0,47
2010,233,Fla. Southern,26,22,0,48
2010,482,Niagara,22,22,0,44
2010,308,IPFW,29,19,0,48
2010,793,Wis.-Eau Claire,21,21,0,42
2010,313,Ithaca,34,15,0,49
2010,9754,UC-Colo. Springs,16,32,0,48
2010,30038,Bethany Lutheran,19,21,0,40
2010,773,McDaniel,16,24,0,40
2010,561,Quincy,37,17,0,54
2010,30092,Flagler,28,24,0,52
2010,2699,IUPUI,16,37,0,53
2010,795,Wis.-La Crosse,38,9,0,47
2010,314,Jackson St.,16,29,0,45
2010,562,Quinnipiac,28,24,0,52
2010,235,Florida,49,10,0,59
2010,316,Jacksonville,33,23,0,56
2010,563,Radford,38,17,0,55
2010,315,Jacksonville St.,30,19,0,49
2010,483,Nicholls St.,25,22,0,47
2010,228,Florida A&M,30,24,0,54
2010,798,Wis.-Oshkosh,22,21,0,43
2010,60,Bethel (MN),23,20,0,43
2010,128,UCF,36,23,0,59
2010,317,James Madison,24,33,0,57
2010,564,Ramapo,29,17,0,46
2010,234,Florida St.,44,18,0,62
2010,110,UCLA,50,11,0,61
2010,484,Nichols,16,22,1,39
2010,500500,Bethel (TN),0,2,0,2
2010,148,Cleveland St.,63,29,0,92
2010,230,Florida Tech,22,28,0,50
2010,164,UConn,21,30,0,51
2010,799,Wis.-Parkside,30,21,0,51
2010,11538,Fontbonne,24,17,0,41
2010,722,Coast Guard,34,10,0,44
2010,401,UMass Boston,21,18,0,39
2010,800,Wis.-Platteville,11,27,0,38
2010,236,Fordham,49,12,0,61
2010,656,UMass Dartmouth,7,22,0,29
2010,61,Bethune-Cookman,32,24,0,56
2010,485,Norfolk St.,14,28,0,42
2010,149,Coastal Caro.,27,31,0,58
2010,801,Wis.-River Falls,24,16,0,40
2010,9011,Fort Hays St.,51,39,0,90
2010,368,UMass Lowell,23,27,0,50
2010,62,Binghamton,24,19,0,43
2010,30083,Cobleskill St.,6,28,0,34
2010,1083,Fort Lewis,17,27,0,44
2010,487,North Ala.,29,29,0,58
2010,802,Wis.-Stevens Point,22,18,0,40
2010,486,MCLA,11,25,0,36
2010,391,UMBC,25,24,0,49
2010,237,Fort Valley St.,32,15,0,47
2010,150,Coe,25,16,0,41
2010,393,UMES,1,33,0,34
2010,566,Randolph,21,22,0,43
2010,803,Wis.-Stout,16,24,0,40
2010,457,North Carolina,42,20,0,62
2010,2707,UMKC,22,26,0,48
2010,28593,Birmingham-So.,25,9,0,34
2010,1023,Coker,15,25,0,40
2010,320,John Carroll,26,15,0,41
2010,804,Wis.-Superior,25,11,1,37
2010,490,North Carolina St.,28,27,0,55
2010,238,Framingham St.,17,22,0,39
2010,1014,Col. of Charleston,24,27,0,51
2010,321,John Jay,13,21,0,34
2010,565,Randolph-Macon,17,13,0,30
2010,805,Wis.-Whitewater,31,15,0,46
2010,665,Southern U.,16,28,0,44
2010,492,North Central (IL),32,14,0,46
2010,796,Wisconsin,20,31,0,51
2010,500088,Col. of Idaho,0,4,0,4
2010,567,Redlands,32,14,0,46
2010,806,Wittenberg,19,21,0,40
2010,667,Southern Utah,10,41,0,51
2010,151,Colby,11,19,0,30
2010,402,McNeese St.,38,27,0,65
2010,1085,Francis Marion,36,16,0,52
2010,787,Wm. Paterson,26,15,1,42
2010,459,UNC Greensboro,27,30,0,57
2010,30069,Franciscan,3,25,0,28
2010,494,North Dakota,16,35,0,51
2010,537,UNC Pembroke,29,19,0,48
2010,568,Regis (CO),22,28,0,50
2010,22626,Johnson & Wales (RI),8,31,0,39
2010,1379,Southern Vt.,3,24,0,27
2010,379,Me.-Farmington,14,14,0,28
2010,239,Frank. & Marsh.,10,18,0,28
2010,460,UNCW,10,41,0,51
2010,153,Colgate,27,23,0,50
2010,807,Wooster,20,20,0,40
2010,493,North Dakota St.,33,25,0,58
2010,569,Regis (MA),9,32,0,41
2010,323,Johnson C. Smith,15,21,0,36
2010,504,UNI,28,25,0,53
2010,809,Worcester St.,20,19,0,39
2010,324,Johnson St.,11,14,0,25
2010,23725,Medaille,23,22,0,45
2010,2711,North Florida,23,31,0,54
2010,570,Rensselaer,19,18,1,38
2010,808,WPI,15,20,0,35
2010,325,Juniata,20,18,0,38
2010,30052,North Georgia,51,2,0,53
2010,727,Union (NY),32,8,0,40
2010,2694,Franklin,16,18,0,34
2010,572,Rhode Island,19,35,0,54
2010,326,Kalamazoo,0,22,0,22
2010,404,Memphis,25,26,0,51
2010,571,Rhode Island Col.,24,13,0,37
2010,2755,Southwest Baptist,28,51,0,79
2010,241,Franklin Pierce,15,28,0,43
2010,573,Rhodes,27,15,0,42
2010,8736,Southwest Minn. St.,18,25,0,43
2010,242,Fredonia,15,20,0,35
2010,810,Wright St.,49,46,1,96
2010,11416,Colorado Mesa,23,22,0,45
2010,155,Colorado Mines,24,26,0,50
2010,156,Colorado St.,29,20,0,49
2010,2720,Colorado St.-Pueblo,28,20,0,48
2010,9223,North Greenville,25,21,0,46
2010,158,Columbia,15,32,0,47
2010,465,UNLV,33,20,0,53
2010,406,Mercer,25,30,0,55
2010,728,Upper Iowa,15,21,0,36
2010,813,Yale,11,28,0,39
2010,724,Merchant Marine,11,18,0,29
2010,328,Kansas,21,35,0,56
2010,407,Mercy,19,27,0,46
2010,30104,Urbana,0,1,0,1
2010,408,Mercyhurst,23,23,0,46
2010,159,Columbus St.,21,28,1,50
2010,730,Ursinus,28,7,0,35
2010,409,Meredith,22,17,0,39
2010,1028,Concord,21,26,0,47
2010,410,Merrimack,17,26,0,43
2010,2730,York (NY),8,21,0,29
2010,411,Messiah,38,9,0,47
2010,10411,USC Upstate,41,15,0,56
2010,64,Blackburn,8,24,0,32
2010,412,Methodist,18,23,0,41
2010,815,York (PA),36,9,0,45
2010,496,North Park,19,18,0,37
2010,413,Metro St.,53,6,0,59
2010,28594,USciences,15,28,0,43
2010,96,Fresno St.,41,21,0,62
2010,8746,Southwestern (TX),33,13,0,46
2010,817,Youngstown St.,33,50,0,83
2010,329,Kean,32,17,0,49
2010,414,Miami (OH),33,24,0,57
2010,984,Bloomfield,14,25,0,39
2010,497,North Texas,29,20,0,49
2010,8744,Southwestern Okla.,25,27,0,52
2010,330,Keene St.,29,14,1,44
2010,695,UT Martin,47,11,0,58
2010,23260,Spalding,16,21,0,37
2010,65,Bloomsburg,50,8,0,58
2010,162,Concordia (NY),22,17,0,39
2010,576,Rider,16,31,1,48
2010,243,Frostburg St.,30,16,0,46
2010,1157,Kennesaw St.,27,26,0,53
2010,26973,Spelman,3,24,0,27
2010,732,Utah,26,29,0,55
2010,244,Furman,24,23,0,47
2010,24400,Concordia (TX),24,16,0,40
2010,985,Bluefield St.,3,36,0,39
2010,253,Ga. Southern,30,26,0,56
2010,160,Concordia Chicago,11,29,0,40
2010,331,Kent St.,33,22,0,55
2010,418,Michigan,49,8,0,57
2010,1097,Ga. Southwestern,20,31,0,51
2010,1036,Concordia Wisconsin,23,20,0,43
2010,577,Ripon,14,20,0,34
2010,245,Gallaudet,3,23,0,26
2010,731,Utah St.,20,30,0,50
2010,987,Bluffton,18,22,0,40
2010,161,Concordia-M'head,11,28,0,39
2010,334,Kentucky,32,27,0,59
2010,246,Gannon,18,21,0,39
2010,1092,Gardner-Webb,22,32,0,54
2010,9081,Concordia-St. Paul,35,17,0,52
2010,18422,Rivier,33,6,0,39
2010,332,Kentucky St.,18,22,0,40
2010,30024,Utah Valley,28,31,0,59
2010,416,Michigan St.,21,31,0,52
2010,12810,Northeastern St.,18,34,0,52
2010,335,Kenyon,18,18,0,36
2010,578,Roanoke,30,9,0,39
2010,1159,Keuka,23,10,0,33
2010,704,UTEP,31,24,0,55
2010,673,Springfield,23,18,1,42
2010,66,Boise St.,29,32,0,61
2010,30047,Keystone,13,24,1,38
2010,579,Robert Morris,28,20,0,48
2010,419,Middle Tenn.,22,32,0,54
2010,502,Northern Colo.,19,33,0,52
2010,67,Boston College,16,33,0,49
2010,503,Northern Ill.,25,34,0,59
2010,505,Northern Ky.,35,20,0,55
2010,581,Rochester (NY),22,19,0,41
2010,68,Boston U.,35,22,0,57
2010,592,St. Andrews,7,38,0,45
2010,69,Bowdoin,34,14,0,48
2010,580,Rochester Inst.,17,21,0,38
2010,1266,Northern St.,10,32,0,42
2010,593,St. Anselm,18,26,0,44
2010,582,Rockford,8,26,0,34
2010,1328,Rockhurst,11,33,0,44
2010,1267,Northland,21,23,0,44
2010,70,Bowie St.,23,21,0,44
2010,507,Northwest Mo. St.,47,35,0,82
2010,583,Roger Williams,20,19,0,39
2010,71,Bowling Green,13,29,0,42
2010,1274,Northwest Nazarene,9,38,0,47
2010,596,St. Bonaventure,13,27,0,40
2010,509,Northwestern,25,23,0,48
2010,72,Bradley,15,34,0,49
2010,73,Brandeis,29,9,1,39
2010,165,Coppin St.,22,22,0,44
2010,597,St. Catherine,9,28,0,37
2010,30094,Brevard,19,26,0,45
2010,584,Rollins,45,6,0,51
2010,74,Bridgeport,4,42,0,46
2010,167,Cornell,37,15,0,52
2010,598,St. Cloud St.,21,27,0,48
2010,75,Bridgewater (VA),33,10,0,43
2010,1334,St. Edward's,34,21,0,55
2010,76,Bridgewater St.,21,21,0,42
2010,585,Rose-Hulman,16,14,0,30
2010,9684,St. Elizabeth,1,35,0,36
2010,15882,Rosemont,0,26,0,26
2010,259,Rowan,28,13,0,41
2010,508,Northwestern St.,27,27,0,54
2010,78,Brockport,32,12,0,44
2010,30031,Northwestern-St. Paul,22,19,0,41
2010,510,Northwood (MI),25,18,0,43
2010,79,Brooklyn,16,17,1,34
2010,80,Brown,20,22,0,42
2010,511,Norwich,12,23,0,35
2010,513,Notre Dame,47,12,0,59
2010,8600,Notre Dame (MD),7,22,0,29
2010,601,St. John Fisher,27,20,0,47
2010,603,St. John's (NY),18,33,0,51
2010,30056,Notre Dame de Namur,13,39,0,52
2010,8687,St. Joseph (CT),24,18,0,42
2010,30072,St. Joseph's (Brkln),28,11,1,40
2010,24639,Nova Southeastern,45,17,0,62
2010,604,St. Joseph's (IN),27,22,0,49
2010,1340,St. Joseph's (L.I.),16,21,0,37
2010,605,St. Joseph's (ME),30,10,0,40
2010,607,St. Lawrence,12,17,0,29
2010,1277,Nyack,2,34,0,36
2010,610,St. Mary's (CA),30,23,0,53
2010,8688,St. Mary's (IN),21,19,0,40
