year,team_id,team_name,wins,losses,ties,total_games
2009,30084,Geneva,25,15,0,40
2009,336,King's (PA),24,14,0,38
2009,733,Utica,16,22,0,38
2009,166,Cornell College,19,20,0,39
2009,420,Middlebury,17,15,0,32
2009,477,NYIT,37,23,1,61
2009,81,Bryant,11,31,0,42
2009,1346,St. Mary's (TX),32,32,0,64
2009,26172,A&M-Corpus Chris,23,31,0,54
2009,587,Rutgers,23,33,0,56
2009,1094,George Fox,5,32,0,37
2009,337,Knox,3,29,0,32
2009,506060,Midland,0,1,0,1
2009,706,UTSA,29,29,0,58
2009,248,George Mason,16,33,0,49
2009,2,Abilene Christian,43,15,0,58
2009,588,Rutgers-Camden,26,19,0,45
2009,249,George Washington,16,33,0,49
2009,929,Adams St.,22,17,0,39
2009,169,Creighton,35,16,0,51
2009,30035,Crown (MN),8,23,0,31
2009,514,Oakland,24,27,0,51
2009,101,CSUN,29,21,0,50
2009,251,Georgetown,17,30,0,47
2009,614,St. Norbert,17,19,0,36
2009,1278,Oakland City,8,22,0,30
2009,589,Rutgers-Newark,4,31,0,35
2009,83,Bucknell,19,32,0,51
2009,745,Va. Wesleyan,27,17,0,44
2009,515,Oberlin,8,26,0,34
2009,339,Kutztown,46,12,1,59
2009,615,St. Olaf,9,29,0,38
2009,84,Buena Vista,8,24,0,32
2009,734,Valdosta St.,56,8,0,64
2009,516,Occidental,14,23,0,37
2009,333,Ky. Wesleyan,20,26,0,46
2009,170,Curry,27,17,0,44
2009,257,Georgia,47,12,0,59
2009,86,Buffalo,25,27,0,52
2009,506055,Valley City St.,0,1,0,1
2009,1222,Midwestern St.,31,17,0,48
2009,1163,La Roche,17,18,0,35
2009,85,Buffalo St.,33,14,0,47
2009,1059,D'Youville,17,17,0,34
2009,340,La Salle,9,29,0,38
2009,1096,Georgia College,32,24,0,56
2009,3,Adelphi,32,14,0,46
2009,254,Georgia St.,30,20,0,50
2009,616,St. Paul's,20,16,0,36
2009,87,Butler,26,28,0,54
2009,423,Millersville,24,25,0,49
2009,735,Valparaiso,25,24,0,49
2009,4,Adrian,34,8,0,42
2009,255,Georgia Tech,46,15,0,61
2009,77,BYU,40,18,0,58
2009,503195,Milligan,0,2,0,2
2009,11324,Agnes Scott,5,22,0,27
2009,519,Ohio,22,25,0,47
2009,341,La Verne,29,17,0,46
2009,2685,BYU-Hawaii,13,27,0,40
2009,618,St. Scholastica,31,12,0,43
2009,424,Millikin,16,24,0,40
2009,88,Cabrini,16,19,0,35
2009,11276,S.C. Aiken,34,16,0,50
2009,1305,Cairn,13,19,0,32
2009,517,Ohio Northern,39,6,0,45
2009,5,Akron,35,24,0,59
2009,105,Cal Lutheran,23,17,0,40
2009,671,La.-Lafayette,45,13,0,58
2009,620,St. Thomas (MN),40,6,0,46
2009,426,Millsaps,15,22,0,37
2009,90,Cal Poly,41,12,0,53
2009,518,Ohio St.,47,11,0,58
2009,10,Ala.-Huntsville,54,6,0,60
2009,498,La.-Monroe,17,35,0,52
2009,1348,St. Thomas Aquinas,5,36,0,41
2009,9004,Georgian Court,40,17,0,57
2009,15207,Ohio Valley,10,36,0,46
2009,102,Sacramento St.,28,23,0,51
2009,92,Cal St. Dom. Hills,35,23,0,58
2009,674,Stanford,48,11,0,59
2009,342,Lafayette,17,29,0,46
2009,520,Ohio Wesleyan,24,16,1,41
2009,675,Staten Island,21,14,0,35
2009,738,Vermont,8,38,0,46
2009,8,Alabama,54,11,0,65
2009,258,Gettysburg,27,10,1,38
2009,427,Minn. Duluth,26,23,0,49
2009,97,Cal St. Fullerton,30,21,0,51
2009,590,Sacred Heart,26,28,0,54
2009,676,Stephen F. Austin,29,27,0,56
2009,1098,Glenville St.,25,24,0,49
2009,6,Alabama A&M,12,23,1,36
2009,1162,LaGrange,25,21,0,46
2009,383,Minn. St. Mankato,39,17,0,56
2009,8366,Goldey-Beacom,19,23,0,42
2009,739,Villanova,23,26,0,49
2009,1044,Dallas,20,17,0,37
2009,7,Alabama St.,14,28,0,42
2009,1240,Minn. St. Moorhead,9,28,0,37
2009,2746,Lake Erie,5,34,0,39
2009,746,Virginia,25,22,0,47
2009,1099,Gordon,10,25,0,35
2009,27854,Minn.-Crookston,0,31,0,31
2009,344,Lake Forest,17,18,0,35
2009,743,Virginia St.,21,12,0,33
2009,501955,Goshen,0,2,0,2
2009,24342,Okla. Panhandle,11,33,0,44
2009,1226,Minn.-Morris,14,23,0,37
2009,506005,Dana,0,1,0,1
2009,345,Lake Superior St.,7,42,0,49
2009,742,Virginia Tech,28,28,0,56
2009,522,Oklahoma,41,16,0,57
2009,14,Albany (NY),38,16,0,54
2009,744,Virginia Union,4,24,0,28
2009,428,Minnesota,23,32,0,55
2009,678,Stetson,23,31,0,54
2009,1164,Lakeland,30,10,0,40
2009,2691,Daniel Webster,19,16,1,36
2009,13,Albany St. (GA),29,26,0,55
2009,2798,Albertus Magnus,0,25,0,25
2009,172,Dartmouth,23,23,0,46
2009,16142,Misericordia,28,16,0,44
2009,15,Albion,14,22,0,36
2009,11036,Sage Colleges,7,29,0,36
2009,16,Albright,5,29,0,34
2009,591,Saginaw Valley,39,11,0,50
2009,21852,Stevenson,13,21,0,34
2009,17,Alcorn,22,24,0,46
2009,594,Saint Augustine's,6,21,0,27
2009,1167,Lander,14,31,0,45
2009,30055,Cal St. Monterey Bay,36,27,1,64
2009,521,Oklahoma St.,36,22,0,58
2009,174,Davis & Elkins,16,39,0,55
2009,934,Alderson Broaddus,24,25,0,49
2009,595,Saint Benedict,13,21,0,34
2009,18,Alfred,27,11,0,38
2009,681,Stockton,27,15,0,42
2009,175,Dayton,13,34,0,47
2009,600,Saint Francis (PA),21,30,0,51
2009,682,Stonehill,13,27,0,40
2009,1050,Defiance,30,16,0,46
2009,93,Cal St. San B'dino,22,36,0,58
2009,19,Allegheny,24,18,0,42
2009,8486,Lasell,21,19,0,40
2009,683,Stony Brook,36,14,0,50
2009,180,Delaware,21,18,0,39
2009,348,Lawrence,10,19,0,29
2009,429,Mississippi Col.,22,17,0,39
2009,103,Cal St. Stanislaus,35,21,0,56
2009,684,Suffolk,22,18,0,40
2009,178,Delaware St.,23,24,0,47
2009,261,Grambling,20,27,0,47
2009,349,Le Moyne,45,13,0,58
2009,179,Delaware Valley,14,16,0,30
2009,430,Mississippi St.,28,28,0,56
2009,606,Saint Joseph's,27,20,0,47
2009,1390,Sul Ross St.,1,39,0,40
2009,351,Lebanon Valley,27,14,0,41
2009,995,Caldwell,37,18,2,57
2009,1104,Grand Canyon,37,27,0,64
2009,181,Delta St.,27,23,0,50
2009,432,Mississippi Val.,38,16,0,54
2009,262,Grand Valley St.,33,18,0,51
2009,182,Denison,21,18,0,39
2009,107,California,38,20,0,58
2009,13302,Lees-McRae,22,20,0,42
2009,794,Green Bay,20,25,0,45
2009,524,Old Westbury,22,14,0,36
2009,434,Missouri,50,12,0,62
2009,11062,Green Mountain,8,20,0,28
2009,106,California (PA),35,10,0,45
2009,748,Wagner,22,29,0,51
2009,263,Greensboro,20,18,0,38
2009,433,Ole Miss,23,29,0,52
2009,608,Saint Leo,30,25,0,55
2009,352,Lehigh,38,18,1,57
2009,435,Missouri S&T,21,28,0,49
2009,176,DePaul,39,14,0,53
2009,1111,Greenville,14,20,0,34
2009,525,Olivet,23,11,0,34
2009,168,SUNY Cortland,44,9,0,53
2009,264,Grinnell,9,22,0,31
2009,669,Missouri St.,19,25,0,44
2009,177,DePauw,32,9,0,41
2009,265,Grove City,16,20,0,36
2009,464,Omaha,45,17,0,62
2009,247,SUNY Geneseo,19,19,0,38
2009,39,GRU Augusta,34,21,0,55
2009,114,Calvin,4,29,0,33
2009,609,Saint Louis,22,33,0,55
2009,1112,Guilford,26,13,0,39
2009,279,Lehman,3,28,0,31
2009,21,Alma,29,13,0,42
2009,398,MIT,6,21,0,27
2009,750,Wartburg,37,8,0,45
2009,996,Cameron,32,22,0,54
2009,266,Gust. Adolphus,42,9,0,51
2009,30042,Mitchell,16,18,1,35
2009,938,Alvernia,15,20,0,35
2009,12399,Gwynedd Mercy,15,22,0,37
2009,1343,Saint Martin's,16,37,0,53
2009,20,DeSales,25,15,0,40
2009,751,Wash. & Jeff.,17,23,0,40
2009,529,Oregon,16,34,0,50
2009,115,Campbell,38,16,0,54
2009,267,Hamilton,5,27,0,32
2009,28746,Alverno,7,23,0,30
2009,475,SUNY New Paltz,19,19,0,38
2009,612,Saint Mary's (MN),18,22,0,40
2009,528,Oregon St.,25,30,0,55
2009,116,Canisius,26,25,0,51
2009,268,Hamline,28,11,0,39
2009,9012,Mo. Southern St.,22,36,0,58
2009,526,SUNY Oneonta,20,21,0,41
2009,613,Saint Michael's,12,26,0,38
2009,2814,Washburn,22,31,0,53
2009,184,Detroit,7,42,0,49
2009,9500,SUNY Poly,7,19,0,26
2009,1170,Lenoir-Rhyne,38,13,0,51
2009,617,Saint Peter's,10,24,0,34
2009,552,SUNY Potsdam,13,21,0,34
2009,117,Capital,20,16,0,36
2009,756,Washington,51,12,0,63
2009,685,Susquehanna,22,15,0,37
2009,22,American Int'l,23,22,0,45
2009,185,Dickinson,17,14,0,31
2009,1347,Saint Rose,15,23,0,38
2009,1029,Washington Adventist,4,20,0,24
2009,24317,Lesley,27,14,0,41
2009,9013,Mo. Western St.,47,11,0,58
2009,24,Amherst,19,8,0,27
2009,686,Swarthmore,15,22,0,37
2009,753,Washington Col.,15,21,1,37
2009,118,Carleton,4,31,0,35
2009,30064,Saint Vincent,11,19,0,30
2009,8490,LeTourneau,14,23,0,37
2009,270,Hampton,26,23,0,49
2009,939,Anderson (IN),23,17,0,40
2009,436,Mo.-St. Louis,36,19,0,55
2009,530,Oswego St.,9,21,0,30
2009,1115,Hanover,5,28,0,33
2009,755,Washington-St. Louis,27,13,0,40
2009,13028,Anderson (SC),19,29,0,48
2009,437,Molloy,21,26,0,47
2009,354,Lewis,38,20,0,58
2009,271,Hardin-Simmons,31,12,0,43
2009,687,Sweet Briar,4,29,0,33
2009,25,Angelo St.,50,10,0,60
2009,439,Monmouth,26,18,1,45
2009,22235,Lewis & Clark,4,36,0,40
2009,438,Monmouth (IL),17,19,0,36
2009,30095,Dixie St.,41,13,0,54
2009,19117,Salem Int'l,1,43,0,44
2009,757,Wayne St. (MI),40,16,0,56
2009,272,Hartford,19,22,0,41
2009,26,Anna Maria,12,25,0,37
2009,688,Syracuse,30,21,0,51
2009,621,Salem St.,18,14,0,32
2009,205,Mont. St. Billings,39,17,0,56
2009,1433,Wayne St. (NE),41,21,0,62
2009,355,Liberty,26,35,0,61
2009,1434,Waynesburg,14,16,0,30
2009,622,Salisbury,40,7,0,47
2009,275,Harvard,27,17,0,44
2009,1174,Limestone,27,26,2,55
2009,623,Salve Regina,25,20,1,46
2009,689,Tampa,27,14,0,41
2009,356,Lincoln (MO),15,39,0,54
2009,27,Appalachian St.,26,29,0,55
2009,531,Otterbein,18,18,0,36
2009,120,Carroll (WI),12,15,0,27
2009,624,Sam Houston St.,28,26,0,54
2009,357,Lincoln (PA),5,19,0,24
2009,276,Haverford,22,12,0,34
2009,1289,Ouachita Baptist,22,29,0,51
2009,1000,Carson-Newman,32,17,0,49
2009,625,Samford,21,30,0,51
2009,1395,Tarleton St.,26,22,0,48
2009,23008,Ozarks (AR),5,35,0,40
2009,121,Carthage,25,12,0,37
2009,627,San Diego,21,33,0,54
2009,277,Hawaii,30,24,0,54
2009,966,Arcadia,27,15,0,42
2009,2697,Hawaii Hilo,26,22,0,48
2009,1176,Lincoln Memorial,17,27,0,44
2009,2696,Hawaii Pacific,42,12,0,54
2009,759,Webster,26,18,0,44
2009,29,Arizona,46,17,0,63
2009,502725,Lindenwood (MO),0,4,0,4
2009,760,Wellesley,21,14,1,36
2009,761,Wells,3,27,0,30
2009,28,Arizona St.,47,19,0,66
2009,278,Heidelberg,5,33,0,38
2009,762,Wentworth,9,23,0,32
2009,763,Wesley,7,22,0,29
2009,1332,Dominican (IL),30,14,0,44
2009,442,Montclair St.,29,18,0,47
2009,712,TCNJ,24,17,0,41
2009,764,Wesleyan (CT),17,20,0,37
2009,8411,Ark.-Monticello,38,16,0,54
2009,8956,Dominican (NY),39,16,0,55
2009,14718,Wesleyan (GA),5,26,0,31
2009,626,San Diego St.,33,20,0,53
2009,690,Temple,15,25,0,40
2009,443,Moravian,35,11,0,46
2009,2678,Ark.-Pine Bluff,10,31,0,41
2009,2692,Dowling,34,20,0,54
2009,358,West Ala.,42,17,0,59
2009,1123,Henderson St.,20,34,0,54
2009,628,San Fran. St.,31,24,0,55
2009,444,Morehead St.,35,20,0,55
2009,189,Drake,30,23,0,53
2009,694,Tennessee,40,18,1,59
2009,31,Arkansas,27,29,0,56
2009,1179,Linfield,39,6,0,45
2009,122,Case,15,24,0,39
2009,691,Tennessee St.,18,31,0,49
2009,1124,Hendrix,22,20,0,42
2009,190,Drew,12,25,0,37
2009,123,Castleton,14,19,0,33
2009,692,Tennessee Tech,26,31,0,57
2009,533,Pace,21,25,0,46
2009,630,San Jose St.,19,37,0,56
2009,446,Morgan St.,15,13,0,28
2009,1001,Catawba,25,19,0,44
2009,30090,Tex. A&M Int'l,25,31,0,56
2009,631,Santa Clara,6,49,0,55
2009,947,Arkansas Tech,42,21,0,63
2009,124,Catholic,16,18,0,34
2009,534,Pacific,18,34,0,52
2009,28600,Lipscomb,39,14,0,53
2009,8398,Hilbert,6,31,0,37
2009,765,West Chester,28,20,0,48
2009,23624,Cazenovia,6,21,0,27
2009,2751,Pacific (OR),27,12,0,39
2009,191,Drexel,24,21,0,45
2009,447,Morningside,0,1,0,1
2009,33,Armstrong,27,23,0,50
2009,632,Savannah St.,15,31,0,46
2009,361,LIU Brooklyn,33,17,0,50
2009,1297,Pacific Lutheran,18,22,0,40
2009,1057,Drury,14,40,0,54
2009,725,Army,21,34,0,55
2009,280,Hillsdale,17,27,0,44
2009,14795,Cedar Crest,11,19,0,30
2009,11740,West Florida,43,18,0,61
2009,362,LIU Post,34,18,0,52
2009,192,Dubuque,12,26,0,38
2009,1355,Schreiner,26,15,0,41
2009,359,Livingstone,0,24,0,24
2009,766,West Ga.,29,27,0,56
2009,633,Scranton,12,18,0,30
2009,535,Paine,15,21,0,36
2009,1356,Seattle,18,20,0,38
2009,1438,West Liberty,18,24,0,42
2009,35,Ashland,36,14,0,50
2009,36,Assumption,20,27,0,47
2009,696,Tex. A&M-Kingsville,32,22,0,54
2009,767,West Tex. A&M,35,21,0,56
2009,281,Hiram,27,16,0,43
2009,635,Seton Hall,24,31,1,56
2009,30088,Tex. Permian Basin,15,36,0,51
2009,30045,Palm Beach Atl.,33,22,0,55
2009,196,East Carolina,40,15,0,55
2009,30063,Seton Hill,26,20,0,46
2009,8965,East Central,12,23,0,35
2009,703,Texas,40,20,0,60
2009,9630,West Va. Wesleyan,45,15,0,60
2009,652,Sewanee,2,20,0,22
2009,125,Centenary (LA),32,23,0,55
2009,697,Texas A&M,32,22,0,54
2009,360,Lock Haven,51,6,0,57
2009,636,Shaw,12,19,0,31
2009,197,East Stroudsburg,20,21,0,41
2009,12884,Centenary (NJ),27,14,0,41
2009,505260,Texas Col.,0,6,0,6
2009,637,Shenandoah,30,13,0,43
2009,126,Central (IA),36,8,0,44
2009,1400,Texas Lutheran,12,26,0,38
2009,198,East Tenn. St.,27,28,0,55
2009,10870,Shepherd,23,23,0,46
2009,1004,Central Ark.,24,31,0,55
2009,1439,West Virginia St.,30,19,0,49
2009,699,Texas Southern,7,31,0,38
2009,127,Central Conn. St.,9,34,0,43
2009,540,Penn,15,28,1,44
2009,1062,East Tex. Baptist,39,9,0,48
2009,638,Shippensburg,26,19,0,45
2009,203,East. Mennonite,21,19,0,40
2009,8968,Eastern,14,18,0,32
2009,37,Auburn,30,29,0,59
2009,200,Eastern Conn. St.,26,13,0,39
2009,670,Texas St.,40,18,0,58
2009,201,Eastern Ill.,25,29,0,54
2009,769,Western Caro.,12,35,0,47
2009,38,Augsburg,12,28,0,40
2009,129,Central Mich.,12,31,0,43
2009,99,Long Beach St.,35,21,0,56
2009,130,Central Mo.,36,14,0,50
2009,770,Western Conn. St.,23,19,0,42
2009,202,Eastern Ky.,17,27,0,44
2009,363,Longwood,23,23,0,46
2009,771,Western Ill.,34,19,0,53
2009,40,Augustana (IL),28,14,0,42
2009,283,Hofstra,26,21,0,47
2009,204,Eastern Mich.,22,30,0,52
2009,364,Loras,14,17,0,31
2009,772,Western Ky.,35,19,0,54
2009,700,Texas Tech,15,42,0,57
2009,1009,Central Okla.,26,15,0,41
2009,206,Eastern N.M.,24,23,0,47
2009,285,Holy Cross,13,34,0,47
2009,1064,Eastern Nazarene,16,19,0,35
2009,639,Siena,12,31,0,43
2009,1065,Eastern Ore.,0,2,0,2
2009,774,Western Mich.,25,22,0,47
2009,41,Augustana (SD),31,23,0,54
2009,1126,Holy Family,22,28,0,50
2009,208,Eckerd,21,38,0,59
2009,1445,Western N.M.,17,31,0,48
2009,640,Simmons,16,23,0,39
2009,539,Penn St.,19,27,0,46
2009,30067,Morrisville St.,5,33,0,38
2009,1066,Edgewood,19,18,0,37
2009,775,Western New Eng.,30,16,0,46
2009,8404,Hood,12,26,0,38
2009,1182,Louisiana Col.,38,9,0,47
2009,701,Texas Woman's,26,25,0,51
2009,30081,Penn St. Harrisburg,10,24,0,34
2009,30036,Mount Aloysius,27,12,0,39
2009,1446,Western Ore.,23,23,0,46
2009,286,Hope,16,24,0,40
2009,702,Texas-Arlington,23,24,0,47
2009,209,Edinboro,26,19,0,45
2009,23121,Texas-Dallas,5,31,0,36
2009,42,Aurora,31,7,0,38
2009,501555,Edward Waters,2,2,0,4
2009,1010,Central Wash.,33,20,0,53
2009,288,Houston,25,24,0,49
2009,366,Louisiana Tech,34,23,0,57
2009,641,Simpson,26,17,0,43
2009,132,Centre,8,25,0,33
2009,953,Austin,12,24,0,36
2009,287,Houston Baptist,18,23,0,41
2009,1012,Chadron St.,20,30,0,50
2009,27901,Mount Ida,10,24,0,34
2009,367,Louisville,48,11,0,59
2009,290,Howard,21,28,0,49
2009,43,Austin Peay,15,38,0,53
2009,30033,Mount Mary,0,27,0,27
2009,133,Chaminade,9,40,0,49
2009,44,Averett,20,17,0,37
2009,134,Chapman,17,20,0,37
2009,1245,Mount Olive,25,18,1,44
2009,30028,Texas-Tyler,39,10,0,49
2009,2741,Howard Payne,29,11,0,40
2009,452,Mount Union,28,16,0,44
2009,707,Thiel,12,24,0,36
2009,1013,Charleston (WV),29,24,0,53
2009,20220,MSOE,6,22,0,28
2009,2758,Thomas (ME),14,18,1,33
2009,291,Humboldt St.,38,20,0,58
2009,48,Charleston So.,26,33,0,59
2009,292,Hunter,19,23,0,42
2009,1402,Thomas More,36,11,0,47
2009,1130,Huntingdon,17,22,1,40
2009,458,Charlotte,33,16,0,49
2009,8567,Mt. St. Joseph,13,23,0,36
2009,10972,Chatham,4,26,0,30
2009,1468,Mt. St. Mary (NY),13,23,0,36
2009,1133,Husson,26,16,0,42
2009,693,Chattanooga,30,24,0,54
2009,450,Mt. St. Mary's,18,30,0,48
2009,1403,Tiffin,23,25,0,48
2009,21323,Chestnut Hill,4,38,0,42
2009,660,SIUE,40,10,0,50
2009,25719,Penn St.-Altoona,7,27,0,34
2009,709,Toledo,8,38,0,46
2009,45,Babson,20,22,0,42
2009,1448,Western Wash.,20,26,0,46
2009,451,Mt. St. Vincent,16,9,0,25
2009,538,Penn St.-Behrend,33,8,0,41
2009,294,Idaho St.,20,21,0,41
2009,371,Loyola Chicago,28,24,0,52
2009,642,Skidmore,21,14,0,35
2009,777,Westfield St.,23,14,0,37
2009,453,Muhlenberg,19,18,0,37
2009,30044,Penn St.-Berks,17,21,0,38
2009,711,Towson,34,22,0,56
2009,94,Bakersfield,28,23,0,51
2009,210,Elizabeth City St.,11,16,0,27
2009,643,Slippery Rock,21,23,0,44
2009,28749,Transylvania,27,12,0,39
2009,137,Chicago,14,14,0,28
2009,300,Ill. Wesleyan,37,6,0,43
2009,644,Smith,6,25,0,31
2009,211,Elizabethtown,11,25,0,36
2009,302,Ill.-Chicago,27,26,0,53
2009,95,Chico St.,19,36,0,55
2009,46,Baldwin Wallace,24,16,0,40
2009,212,Elmhurst,14,22,0,36
2009,8875,Chowan,30,21,0,51
2009,370,Loyola Marymount,24,30,0,54
2009,139,Chris. Newport,36,9,0,45
2009,645,Sonoma St.,36,25,0,61
2009,47,Ball St.,29,24,0,53
2009,1015,Christian Bros.,20,24,0,44
2009,213,Elmira,16,11,0,27
2009,455,Muskingum,26,16,0,42
2009,958,Baptist Bible (PA),15,23,0,38
2009,1450,Westminster (MO),12,22,0,34
2009,30037,Trine,29,12,0,41
2009,646,South Ala.,27,28,1,56
2009,713,Trinity (CT),14,17,0,31
2009,532,Elms,17,14,0,31
2009,301,Illinois,29,17,0,46
2009,488,N.C. A&T,26,23,0,49
2009,1451,Westminster (PA),17,21,1,39
2009,365,LSU,34,18,1,53
2009,542,Pfeiffer,26,17,0,43
2009,489,N.C. Central,5,43,0,48
2009,648,South Carolina,21,24,0,45
2009,715,Trinity (TX),13,22,0,35
2009,1068,Elon,15,32,0,47
2009,491,N.C. Wesleyan,13,27,0,40
2009,543,Philadelphia U.,25,21,0,46
2009,647,South Carolina St.,7,30,0,37
2009,49,Barry,32,19,0,51
2009,8577,N.M. Highlands,8,47,0,55
2009,214,Emerson,33,11,0,44
2009,716,Troy,38,19,0,57
2009,650,South Dakota,33,18,0,51
2009,15646,Barton,14,22,0,36
2009,8580,City Tech,0,2,0,2
2009,21830,Piedmont,15,17,0,32
2009,499,Truman,11,34,0,45
2009,717,Tufts,44,3,0,47
2009,58,Baruch,19,21,0,40
2009,50,Bates,12,16,0,28
2009,26520,Bay Path,17,19,0,36
2009,778,Wheaton (IL),18,21,0,39
2009,297,Illinois Col.,11,22,0,33
2009,779,Wheaton (MA),15,23,0,38
2009,30058,Claflin,19,12,0,31
2009,51,Baylor,40,22,0,62
2009,26107,Becker,3,23,0,26
2009,12799,Wheeling Jesuit,23,24,0,47
2009,299,Illinois St.,24,26,0,50
2009,52,Bellarmine,24,31,0,55
2009,8896,Wheelock,7,21,0,28
2009,461,Nazareth,17,17,0,34
2009,14927,Belmont,11,35,0,46
2009,544,Pine Manor,21,20,0,41
2009,462,Neb. Wesleyan,20,16,0,36
2009,719,Tulsa,40,17,0,57
2009,2683,Belmont Abbey,11,35,0,46
2009,1315,Pitt.-Bradford,17,18,1,36
2009,1156,Neb.-Kearney,15,28,0,43
2009,781,Whittier,24,18,0,42
2009,215,Emmanuel (MA),11,23,0,34
2009,53,Beloit,10,24,0,34
2009,11839,Pitt.-Greensburg,17,16,0,33
2009,463,Nebraska,35,19,0,54
2009,1454,Whitworth,15,21,0,36
2009,54,Bemidji St.,8,28,0,36
2009,1254,Neumann,31,12,0,43
2009,782,Wichita St.,21,32,0,53
2009,55,Benedict,14,18,0,32
2009,303,Immaculata,17,18,0,35
2009,217,Emory,32,12,0,44
2009,466,Nevada,40,19,0,59
2009,1314,Pittsburg St.,31,24,0,55
2009,12830,Tusculum,15,33,0,48
2009,296,Benedictine (IL),31,12,0,43
2009,467,New England Col.,10,28,0,38
2009,783,Widener,24,18,0,42
2009,545,Pittsburgh,25,24,0,49
2009,216,Emory & Henry,4,24,0,28
2009,372,Luther,35,11,0,46
2009,720,Tuskegee,18,15,0,33
2009,547,Plattsburgh St.,19,23,0,42
2009,548,Plymouth St.,24,18,0,42
2009,56,Bentley,21,19,0,40
2009,649,South Dakota St.,10,41,0,51
2009,2743,Incarnate Word,28,33,0,61
2009,1071,Emporia St.,43,16,0,59
2009,651,South Fla.,34,22,0,56
2009,470,New Haven,34,18,0,52
2009,1255,U New England,22,13,1,36
2009,8981,Endicott,38,9,0,47
2009,306,Indiana,10,39,0,49
2009,1072,Erskine,22,20,0,42
2009,373,Lycoming,12,22,0,34
2009,784,Wilkes,18,21,0,39
2009,218,Eureka,10,22,0,32
2009,654,Southeast Mo. St.,29,21,0,50
2009,307,Indiana (PA),19,19,0,38
2009,481,Polytechnic (NY),11,19,0,30
2009,59,Bethany (WV),24,21,0,45
2009,319,New Jersey City,16,22,0,38
2009,785,Willamette,29,6,0,35
2009,549,Pomona-Pitzer,11,27,0,38
2009,9,UAB,21,34,0,55
2009,30038,Bethany Lutheran,9,27,0,36
2009,219,Evansville,14,34,0,48
2009,655,Southeastern La.,20,33,0,53
2009,374,Lynchburg,38,8,1,47
2009,473,New Mexico,13,35,0,48
2009,142,Claremont-M-S,28,16,0,44
2009,1371,Southeastern Okla.,53,13,0,66
2009,30065,Lyndon St.,8,19,0,27
2009,472,New Mexico St.,33,21,0,54
2009,305,Indiana St.,20,27,0,47
2009,143,Clarion,5,33,0,38
2009,550,Portland St.,29,26,0,55
2009,1376,Southern Ark.,9,36,0,45
2009,220,Fairfield,21,28,0,49
2009,145,Clark (MA),17,18,0,35
2009,60,Bethel (MN),23,19,0,42
2009,20794,Lynn,21,29,0,50
2009,144,Clark Atlanta,19,37,0,56
2009,1318,Post,25,20,0,45
2009,108,UC Davis,22,32,0,54
2009,222,Fairleigh Dickinson,11,39,0,50
2009,553,Prairie View,8,32,0,40
2009,61,Bethune-Cookman,20,36,0,56
2009,376,Macalester,10,28,0,38
2009,17094,William Peace,19,19,0,38
2009,62,Binghamton,7,36,0,43
2009,1076,Fairmont St.,32,16,0,48
2009,377,MacMurray,9,27,0,36
2009,111,UC Riverside,18,32,0,50
2009,309,Indianapolis,37,21,0,58
2009,1320,Presbyterian,18,27,0,45
2009,658,Southern Conn. St.,33,16,0,49
2009,310,Iona,13,27,0,40
2009,28593,Birmingham-So.,32,5,0,37
2009,380,Maine,32,22,0,54
2009,27892,Farmingdale St.,34,6,0,40
2009,312,Iowa,42,16,0,58
2009,378,Maine Maritime,4,20,0,24
2009,112,UC San Diego,30,25,0,55
2009,311,Iowa St.,26,29,0,55
2009,659,Southern Ill.,33,13,0,46
2009,30034,Presentation,3,25,0,28
2009,223,Fayetteville St.,26,25,0,51
2009,104,UC Santa Barbara,26,25,0,51
2009,789,Williams,16,17,0,33
2009,308,IPFW,14,24,0,38
2009,554,Princeton,14,22,0,36
2009,661,Southern Ind.,18,33,0,51
2009,221,FDU-Florham,18,16,0,34
2009,9754,UC-Colo. Springs,15,27,0,42
2009,1460,Wilmington (DE),22,24,0,46
2009,662,Southern Me.,6,36,0,42
2009,128,UCF,27,27,0,54
2009,23157,Felician,10,33,0,43
2009,313,Ithaca,27,16,0,43
2009,1461,Wilmington (OH),7,27,0,34
2009,12973,Wilson,12,10,0,22
2009,110,UCLA,45,11,0,56
2009,224,Ferris St.,35,10,0,45
2009,2699,IUPUI,3,50,0,53
2009,1462,Wingate,33,16,1,50
2009,1257,Newberry,30,16,0,46
2009,164,UConn,29,22,0,51
2009,225,Ferrum,18,21,0,39
2009,664,Southern Miss.,26,28,2,56
2009,64,Blackburn,3,31,0,34
2009,148,Cleveland St.,35,18,0,53
2009,314,Jackson St.,21,25,0,46
2009,790,Winona St.,50,13,0,63
2009,21772,Newbury,2,28,0,30
2009,401,UMass Boston,11,21,0,32
2009,984,Bloomfield,33,15,0,48
2009,791,Winston-Salem,14,26,0,40
2009,28755,FGCU,47,9,0,56
2009,722,Coast Guard,39,7,1,47
2009,65,Bloomsburg,35,11,0,46
2009,316,Jacksonville,24,31,0,55
2009,468,Southern N.H.,21,24,0,45
2009,792,Winthrop,26,21,0,47
2009,1079,Findlay,20,23,0,43
2009,149,Coastal Caro.,15,38,0,53
2009,30054,Newman,4,35,0,39
2009,30032,Finlandia,20,12,0,32
2009,8911,Wis. Lutheran,10,22,0,32
2009,985,Bluefield St.,5,26,0,31
2009,1192,Manchester,17,20,0,37
2009,30083,Cobleskill St.,8,16,0,24
2009,656,UMass Dartmouth,7,23,0,30
2009,793,Wis.-Eau Claire,28,16,0,44
2009,987,Bluffton,30,13,0,43
2009,556,Providence,17,34,0,51
2009,795,Wis.-La Crosse,34,12,0,46
2009,227,Fitchburg St.,5,27,0,32
2009,381,Manhattan,20,27,0,47
2009,66,Boise St.,22,30,0,52
2009,315,Jacksonville St.,43,16,0,59
2009,368,UMass Lowell,10,31,1,42
2009,798,Wis.-Oshkosh,20,17,0,37
2009,482,Niagara,30,19,0,49
2009,67,Boston College,18,33,0,51
2009,557,Puget Sound,16,24,0,40
2009,799,Wis.-Parkside,17,19,0,36
2009,382,Manhattanville,19,19,0,38
2009,231,FIU,31,29,0,60
2009,317,James Madison,35,16,0,51
2009,800,Wis.-Platteville,5,29,0,34
2009,30029,Purchase,17,14,0,31
2009,150,Coe,41,13,0,54
2009,391,UMBC,34,21,0,55
2009,483,Nicholls St.,30,25,0,55
2009,506057,Jamestown,0,2,0,2
2009,229,Fla. Atlantic,30,30,0,60
2009,801,Wis.-River Falls,27,16,0,43
2009,68,Boston U.,43,18,0,61
2009,802,Wis.-Stevens Point,21,20,0,41
2009,559,Purdue,31,20,0,51
2009,1023,Coker,22,19,0,41
2009,484,Nichols,17,24,0,41
2009,69,Bowdoin,22,16,1,39
2009,803,Wis.-Stout,19,21,0,40
2009,70,Bowie St.,26,8,0,34
2009,1014,Col. of Charleston,23,26,0,49
2009,804,Wis.-Superior,16,20,0,36
2009,320,John Carroll,28,11,0,39
2009,71,Bowling Green,13,33,0,46
2009,393,UMES,20,18,0,38
2009,805,Wis.-Whitewater,38,7,0,45
2009,321,John Jay,13,21,0,34
2009,233,Fla. Southern,43,15,0,58
2009,485,Norfolk St.,22,25,0,47
2009,796,Wisconsin,15,40,0,55
2009,2707,UMKC,20,34,0,54
2009,30092,Flagler,18,31,0,49
2009,487,North Ala.,20,29,0,49
2009,806,Wittenberg,18,20,0,38
2009,72,Bradley,26,28,0,54
2009,384,Mansfield,14,20,0,34
2009,457,North Carolina,47,13,0,60
2009,22626,Johnson & Wales (RI),8,31,0,39
2009,235,Florida,63,5,0,68
2009,323,Johnson C. Smith,9,17,0,26
2009,787,Wm. Paterson,35,9,0,44
2009,490,North Carolina St.,23,25,0,48
2009,73,Brandeis,28,17,0,45
2009,500088,Col. of Idaho,2,7,0,9
2009,324,Johnson St.,8,17,0,25
2009,459,UNC Greensboro,26,33,0,59
2009,492,North Central (IL),27,12,0,39
2009,1194,Maranatha Baptist,0,29,0,29
2009,30094,Brevard,17,27,0,44
2009,151,Colby,18,11,0,29
2009,11504,Queens (NC),27,26,0,53
2009,74,Bridgeport,12,27,0,39
2009,325,Juniata,24,15,0,39
2009,537,UNC Pembroke,18,30,0,48
2009,560,Queens (NY),23,23,0,46
2009,665,Southern U.,21,21,0,42
2009,75,Bridgewater (VA),36,11,0,47
2009,153,Colgate,25,18,0,43
2009,494,North Dakota,9,33,0,42
2009,561,Quincy,28,25,0,53
2009,460,UNCW,13,32,0,45
2009,1196,Marian (WI),20,18,0,38
2009,562,Quinnipiac,18,30,0,48
2009,667,Southern Utah,24,31,0,55
2009,493,North Dakota St.,38,20,0,58
2009,807,Wooster,6,34,0,40
2009,504,UNI,34,22,0,56
2009,228,Florida A&M,30,32,0,62
2009,328,Kansas,21,31,0,52
2009,809,Worcester St.,10,21,1,32
2009,385,Marietta,23,13,0,36
2009,563,Radford,41,15,0,56
2009,154,Colorado Col.,4,19,0,23
2009,808,WPI,16,23,0,39
2009,564,Ramapo,26,11,0,37
2009,727,Union (NY),31,6,0,37
2009,329,Kean,19,21,0,40
2009,1379,Southern Vt.,3,24,0,27
2009,566,Randolph,19,15,0,34
2009,11416,Colorado Mesa,30,21,0,51
2009,2711,North Florida,26,24,0,50
2009,386,Marist,16,33,0,49
2009,810,Wright St.,34,21,0,55
2009,330,Keene St.,30,14,0,44
2009,234,Florida St.,44,16,0,60
2009,565,Randolph-Macon,15,17,0,32
2009,155,Colorado Mines,39,19,0,58
2009,567,Redlands,30,12,0,42
2009,30052,North Georgia,50,5,0,55
2009,1157,Kennesaw St.,21,30,0,51
2009,156,Colorado St.,26,25,0,51
2009,568,Regis (CO),31,25,0,56
2009,76,Bridgewater St.,28,11,0,39
2009,230,Florida Tech,21,26,0,47
2009,331,Kent St.,25,26,0,51
2009,569,Regis (MA),5,32,0,37
2009,2720,Colorado St.-Pueblo,31,20,0,51
2009,570,Rensselaer,26,14,0,40
2009,465,UNLV,31,21,0,52
2009,9223,North Greenville,18,18,0,36
2009,334,Kentucky,34,23,0,57
2009,11538,Fontbonne,21,18,0,39
2009,572,Rhode Island,14,37,0,51
2009,496,North Park,12,18,0,30
2009,1199,Mars Hill,26,19,0,45
2009,332,Kentucky St.,22,18,0,40
2009,728,Upper Iowa,22,24,0,46
2009,571,Rhode Island Col.,42,7,0,49
2009,813,Yale,22,22,0,44
2009,335,Kenyon,18,18,0,36
2009,236,Fordham,37,22,0,59
2009,573,Rhodes,29,12,0,41
2009,497,North Texas,26,28,0,54
2009,1159,Keuka,24,8,0,32
2009,388,Marshall,31,20,0,51
2009,30047,Keystone,12,22,0,34
2009,9011,Fort Hays St.,31,33,0,64
2009,78,Brockport,28,13,1,42
2009,8597,Martin Luther,18,17,0,35
2009,158,Columbia,16,34,0,50
2009,730,Ursinus,28,10,0,38
2009,1083,Fort Lewis,19,24,0,43
2009,79,Brooklyn,4,21,0,25
2009,237,Fort Valley St.,24,23,0,47
2009,30075,Mary,16,33,0,49
2009,80,Brown,12,26,0,38
2009,576,Rider,16,32,0,48
2009,10411,USC Upstate,29,16,0,45
2009,2755,Southwest Baptist,23,35,0,58
2009,238,Framingham St.,14,27,0,41
2009,28594,USciences,12,30,0,42
2009,159,Columbus St.,30,31,0,61
2009,577,Ripon,20,14,0,34
2009,2730,York (NY),2,22,0,24
2009,8736,Southwest Minn. St.,32,23,0,55
2009,18422,Rivier,17,16,0,33
2009,695,UT Martin,38,24,0,62
2009,815,York (PA),30,15,0,45
2009,578,Roanoke,24,11,0,35
2009,12810,Northeastern St.,9,35,0,44
2009,579,Robert Morris,25,21,0,46
2009,732,Utah,22,31,0,53
2009,1085,Francis Marion,32,19,0,51
2009,389,Mary Baldwin,4,34,0,38
2009,1028,Concord,1,29,0,30
2009,8746,Southwestern (TX),19,16,0,35
2009,817,Youngstown St.,8,42,0,50
2009,502,Northern Colo.,18,32,0,50
2009,30069,Franciscan,1,26,0,27
2009,503,Northern Ill.,20,37,0,57
2009,239,Frank. & Marsh.,16,20,0,36
2009,731,Utah St.,10,37,0,47
2009,505,Northern Ky.,32,23,0,55
2009,1203,Mary Hardin-Baylor,20,20,0,40
2009,581,Rochester (NY),33,12,0,45
2009,2694,Franklin,10,24,0,34
2009,30024,Utah Valley,16,27,0,43
2009,1266,Northern St.,10,32,0,42
2009,241,Franklin Pierce,5,37,0,42
2009,390,Mary Washington,25,16,1,42
2009,503129,Rochester College,0,2,0,2
2009,704,UTEP,27,29,1,57
2009,8744,Southwestern Okla.,14,28,0,42
2009,1267,Northland,20,21,0,41
2009,242,Fredonia,15,20,1,36
2009,507,Northwest Mo. St.,13,38,0,51
2009,1274,Northwest Nazarene,9,44,0,53
2009,580,Rochester Inst.,19,18,0,37
2009,509,Northwestern,31,15,0,46
2009,582,Rockford,17,21,0,38
2009,1328,Rockhurst,19,21,0,40
2009,392,Maryland,29,26,0,55
2009,96,Fresno St.,38,20,0,58
2009,506072,Northwestern (IA),0,1,0,1
2009,583,Roger Williams,28,17,0,45
2009,243,Frostburg St.,26,18,0,44
2009,244,Furman,22,29,0,51
2009,584,Rollins,47,10,0,57
2009,508,Northwestern St.,5,45,0,50
2009,253,Ga. Southern,29,25,0,54
2009,26973,Spelman,2,27,0,29
2009,30031,Northwestern-St. Paul,20,23,0,43
2009,1097,Ga. Southwestern,13,37,0,50
2009,510,Northwood (MI),17,24,0,41
2009,245,Gallaudet,4,22,0,26
2009,511,Norwich,18,17,0,35
2009,246,Gannon,22,21,0,43
2009,513,Notre Dame,43,17,0,60
2009,1092,Gardner-Webb,19,27,0,46
2009,162,Concordia (NY),14,16,0,30
2009,505050,Spring Hill,0,4,0,4
2009,8600,Notre Dame (MD),1,23,0,24
2009,585,Rose-Hulman,12,20,0,32
2009,24400,Concordia (TX),20,20,0,40
2009,15882,Rosemont,1,26,0,27
2009,673,Springfield,23,24,0,47
2009,160,Concordia Chicago,8,26,0,34
2009,259,Rowan,35,12,0,47
2009,30056,Notre Dame de Namur,10,38,1,49
2009,1036,Concordia Wisconsin,25,23,0,48
2009,395,Maryville (MO),24,16,0,40
2009,161,Concordia-M'head,14,22,0,36
2009,24639,Nova Southeastern,49,15,0,64
2009,1277,Nyack,3,33,0,36
2009,9081,Concordia-St. Paul,33,23,0,56
2009,592,St. Andrews,21,27,0,48
2009,593,St. Anselm,18,25,1,44
2009,396,Maryville (TN),21,15,0,36
2009,397,Marywood,27,11,0,38
2009,596,St. Bonaventure,12,28,0,40
2009,597,St. Catherine,12,23,0,35
2009,598,St. Cloud St.,21,38,0,59
2009,1334,St. Edward's,41,21,0,62
2009,165,Coppin St.,5,27,0,32
2009,400,Massachusetts,41,10,0,51
2009,9684,St. Elizabeth,14,27,0,41
2009,773,McDaniel,13,22,0,35
2009,167,Cornell,42,13,0,55
2009,486,MCLA,10,24,0,34
2009,402,McNeese St.,31,28,0,59
2009,601,St. John Fisher,32,12,0,44
2009,603,St. John's (NY),24,26,0,50
2009,379,Me.-Farmington,17,13,0,30
2009,8687,St. Joseph (CT),16,20,0,36
2009,30072,St. Joseph's (Brkln),26,10,0,36
2009,23725,Medaille,20,19,0,39
2009,604,St. Joseph's (IN),29,19,0,48
2009,1340,St. Joseph's (L.I.),9,22,0,31
2009,605,St. Joseph's (ME),29,14,0,43
2009,607,St. Lawrence,5,25,0,30
2009,506064,St. Mary (KS),0,1,0,1
2009,404,Memphis,22,30,0,52
2009,610,St. Mary's (CA),25,28,0,53
2009,8688,St. Mary's (IN),22,12,0,34
2009,406,Mercer,40,19,0,59
2009,724,Merchant Marine,19,18,0,37
2009,407,Mercy,15,17,0,32
2009,408,Mercyhurst,20,23,0,43
2009,409,Meredith,13,19,0,32
2009,410,Merrimack,26,19,0,45
2009,411,Messiah,43,4,0,47
2009,412,Methodist,17,26,0,43
2009,413,Metro St.,40,12,0,52
2009,414,Miami (OH),33,24,0,57
2009,418,Michigan,47,12,0,59
2009,416,Michigan St.,21,28,0,49
2009,419,Middle Tenn.,14,34,0,48
